0,2,2,0,0,0,0,0,0,0,2,2,0,0,0
0,1,1,0,0,0,0,0,0,0,1,1,0,0,0
14,2,16,0,0,0,0,0,0,14,2,16,0,0,0
60,55,115,0,0,0,0,0,0,60,55,115,0,0,0
1,0,1,0,0,0,0,0,0,1,0,1,0,0,0
1,1,2,0,0,0,0,0,0,1,1,2,0,0,0
1,0,1,0,0,0,0,0,0,1,0,1,0,0,0
3,2,5,0,0,0,0,0,0,3,2,5,0,0,0
0,1,1,0,0,0,0,0,0,0,1,1,0,0,0
0,1,1,0,0,0,0,0,0,0,1,1,0,0,0
2,1,3,0,0,0,0,0,0,2,1,3,0,0,0
38,37,75,0,0,0,0,0,0,35,37,72,3,0,3
1,0,1,0,0,0,0,0,0,1,0,1,0,0,0
38,29,67,0,0,0,0,0,0,36,29,65,2,0,2
8,13,21,0,0,0,0,0,0,8,12,20,0,1,1
3,1,4,0,0,0,0,0,0,3,1,4,0,0,0
7,4,11,0,0,0,0,0,0,7,4,11,0,0,0
1,0,1,0,0,0,0,0,0,1,0,1,0,0,0
173,123,296,0,0,0,0,0,0,160,120,280,13,3,16
1,6,7,0,0,0,0,0,0,1,6,7,0,0,0
8,3,11,0,0,0,0,0,0,8,3,11,0,0,0
0,1,1,0,0,0,0,0,0,0,1,1,0,0,0
1,0,1,0,0,0,0,0,0,1,0,1,0,0,0
0,1,1,0,0,0,0,0,0,0,1,1,0,0,0
1,0,1,0,0,0,0,0,0,1,0,1,0,0,0
4,16,20,0,0,0,0,0,0,4,15,19,0,1,1
0,3,3,0,0,0,0,0,0,0,3,3,0,0,0
1,0,1,0,0,0,0,0,0,1,0,1,0,0,0
1,1,2,0,0,0,0,0,0,1,1,2,0,0,0
34,33,67,0,0,0,0,0,0,33,31,64,1,2,3
0,1,1,0,0,0,0,0,0,0,1,1,0,0,0
0,1,1,0,0,0,0,0,0,0,1,1,0,0,0
1,0,1,0,0,0,0,0,0,1,0,1,0,0,0
13,12,25,0,0,0,0,0,0,12,11,23,1,1,2
8,5,13,0,0,0,0,0,0,8,5,13,0,0,0
19,14,33,0,0,0,0,0,0,19,14,33,0,0,0
0,1,1,0,0,0,0,0,0,0,1,1,0,0,0
1,0,1,0,0,0,0,0,0,1,0,1,0,0,0
1,0,1,0,0,0,0,0,0,1,0,1,0,0,0
0,1,1,0,0,0,0,0,0,0,1,1,0,0,0
0,1,1,0,0,0,0,0,0,0,1,1,0,0,0
1,0,1,0,0,0,0,0,0,1,0,1,0,0,0
1,0,1,0,0,0,0,0,0,1,0,1,0,0,0
1,0,1,0,0,0,0,0,0,1,0,1,0,0,0
1,0,1,0,0,0,0,0,0,1,0,1,0,0,0
1,0,1,0,0,0,0,0,0,1,0,1,0,0,0
1,0,1,0,0,0,0,0,0,1,0,1,0,0,0
4,0,4,0,0,0,0,0,0,4,0,4,0,0,0
3,3,6,0,0,0,0,0,0,2,3,5,1,0,1
0,1,1,0,0,0,0,0,0,0,1,1,0,0,0
1,0,1,0,0,0,0,0,0,1,0,1,0,0,0
1,0,1,0,0,0,0,0,0,1,0,1,0,0,0
0,1,1,0,0,0,0,0,0,0,1,1,0,0,0
2,2,4,0,0,0,0,0,0,1,2,3,1,0,1
4,5,9,0,0,0,0,0,0,4,5,9,0,0,0
63,61,124,0,0,0,0,0,0,61,57,118,2,4,6
0,1,1,0,0,0,0,0,0,0,1,1,0,0,0
0,1,1,0,0,0,0,0,0,0,1,1,0,0,0
20,15,35,0,0,0,0,0,0,18,15,33,2,0,2
2,7,9,0,0,0,0,0,0,2,7,9,0,0,0
1,1,2,0,0,0,0,0,0,1,1,2,0,0,0
1,3,4,0,0,0,0,0,0,1,3,4,0,0,0
1,1,2,0,0,0,0,0,0,1,1,2,0,0,0
1,0,1,0,0,0,0,0,0,1,0,1,0,0,0
1,0,1,0,0,0,0,0,0,1,0,1,0,0,0
0,5,5,0,0,0,0,0,0,0,5,5,0,0,0
0,2,2,0,0,0,0,0,0,0,2,2,0,0,0
1,1,2,0,0,0,0,0,0,1,1,2,0,0,0
2,0,2,0,0,0,0,0,0,2,0,2,0,0,0
0,1,1,0,0,0,0,0,0,0,1,1,0,0,0
1,0,1,0,0,0,0,0,0,1,0,1,0,0,0
1,4,5,0,0,0,0,0,0,1,4,5,0,0,0
0,1,1,0,0,0,0,0,0,0,1,1,0,0,0
1,0,1,0,0,0,0,0,0,1,0,1,0,0,0
15,14,29,0,0,0,0,0,0,14,12,26,1,2,3
1,0,1,0,0,0,0,0,0,1,0,1,0,0,0
32,29,61,0,0,0,0,0,0,31,28,59,1,1,2
60,48,108,0,0,0,0,0,0,54,44,98,6,4,10
7,6,13,0,0,0,0,0,0,5,5,10,2,1,3
0,2,2,0,0,0,0,0,0,0,2,2,0,0,0
13,15,28,0,0,0,0,0,0,11,15,26,2,0,2
68,60,128,0,0,0,0,0,0,64,57,121,4,3,7
0,1,1,0,0,0,0,0,0,0,1,1,0,0,0
12,10,22,0,0,0,0,0,0,12,10,22,0,0,0
4,3,7,0,0,0,0,0,0,4,3,7,0,0,0
10,10,20,0,0,0,0,0,0,10,10,20,0,0,0
1,0,1,0,0,0,0,0,0,1,0,1,0,0,0
13,7,20,0,0,0,0,0,0,10,6,16,3,1,4
39,69,108,0,0,0,0,0,0,38,68,106,1,1,2
7,13,20,0,0,0,0,0,0,7,13,20,0,0,0
16,35,51,0,0,0,0,0,0,16,34,50,0,1,1
1,321,322,0,0,0,0,0,0,1,273,274,0,48,48
20,4,24,0,0,0,0,0,0,19,4,23,1,0,1
0,1,1,0,1,1,0,0,0,0,1,1,0,0,0
9,4,13,0,0,0,0,0,0,8,4,12,1,0,1
3,3,6,0,0,0,0,0,0,3,3,6,0,0,0
0,2,2,0,0,0,0,0,0,0,1,1,0,1,1
0,1,1,0,0,0,0,0,0,0,1,1,0,0,0
7,1,8,0,0,0,0,0,0,6,1,7,1,0,1
1,0,1,0,0,0,0,0,0,1,0,1,0,0,0
1,1,2,0,0,0,0,0,0,1,1,2,0,0,0
1,2,3,0,0,0,0,0,0,1,2,3,0,0,0
1,0,1,0,0,0,0,0,0,1,0,1,0,0,0
1,1,2,0,0,0,0,0,0,1,1,2,0,0,0
1,0,1,0,0,0,0,0,0,1,0,1,0,0,0
1,2,3,0,0,0,0,0,0,1,2,3,0,0,0
16,9,25,0,0,0,0,0,0,12,9,21,4,0,4
17,21,38,0,0,0,0,0,0,17,19,36,0,2,2
1,0,1,0,0,0,0,0,0,1,0,1,0,0,0
0,1,1,0,0,0,0,0,0,0,1,1,0,0,0
1,0,1,0,0,0,0,0,0,1,0,1,0,0,0
1,1,2,0,0,0,0,0,0,1,1,2,0,0,0
13,39,52,0,0,0,0,0,0,12,38,50,1,1,2
11,10,21,0,0,0,0,0,0,11,10,21,0,0,0
0,1,1,0,0,0,0,0,0,0,1,1,0,0,0
0,2,2,0,0,0,0,0,0,0,2,2,0,0,0
16,12,28,0,0,0,0,0,0,16,12,28,0,0,0
5,4,9,0,0,0,0,0,0,5,4,9,0,0,0
0,1,1,0,0,0,0,0,0,0,0,0,0,1,1
1,0,1,0,0,0,0,0,0,1,0,1,0,0,0
5,10,15,0,0,0,0,0,0,5,10,15,0,0,0
26,24,50,0,0,0,0,0,0,23,20,43,3,4,7
1,0,1,0,0,0,0,0,0,1,0,1,0,0,0
1,2,3,0,0,0,0,0,0,1,2,3,0,0,0
0,1,1,0,0,0,0,0,0,0,1,1,0,0,0
0,1,1,0,0,0,0,0,0,0,1,1,0,0,0
0,1,1,0,0,0,0,0,0,0,1,1,0,0,0
0,1,1,0,0,0,0,0,0,0,1,1,0,0,0
0,1,1,0,0,0,0,0,0,0,1,1,0,0,0
0,1,1,0,0,0,0,0,0,0,1,1,0,0,0
1,0,1,0,0,0,0,0,0,1,0,1,0,0,0
0,1,1,0,0,0,0,0,0,0,0,0,0,1,1
0,2,2,0,0,0,0,0,0,0,2,2,0,0,0
31,46,77,0,0,0,0,0,0,29,44,73,2,2,4
0,1,1,0,0,0,0,0,0,0,1,1,0,0,0
0,1,1,0,0,0,0,0,0,0,1,1,0,0,0
0,1,1,0,0,0,0,0,0,0,1,1,0,0,0
0,8,8,0,0,0,0,0,0,0,8,8,0,0,0
0,4,4,0,0,0,0,0,0,0,4,4,0,0,0
7,0,7,0,0,0,0,0,0,2,0,2,5,0,5
1,0,1,0,0,0,0,0,0,1,0,1,0,0,0
0,1,1,0,0,0,0,0,0,0,1,1,0,0,0
1,0,1,0,0,0,0,0,0,1,0,1,0,0,0
0,1,1,0,0,0,0,0,0,0,1,1,0,0,0
1,0,1,0,0,0,0,0,0,1,0,1,0,0,0
0,1,1,0,0,0,0,0,0,0,1,1,0,0,0
0,1,1,0,0,0,0,0,0,0,1,1,0,0,0
0,1,1,0,0,0,0,0,0,0,1,1,0,0,0
1,0,1,0,0,0,0,0,0,1,0,1,0,0,0
0,1,1,0,0,0,0,0,0,0,1,1,0,0,0
0,1,1,0,0,0,0,0,0,0,1,1,0,0,0
0,1,1,0,0,0,0,0,0,0,1,1,0,0,0
0,1,1,0,0,0,0,0,0,0,1,1,0,0,0
1,3,4,0,0,0,0,0,0,1,3,4,0,0,0
0,2,2,0,0,0,0,0,0,0,2,2,0,0,0
2,1,3,0,0,0,0,0,0,2,1,3,0,0,0
2,2,4,0,0,0,0,0,0,2,1,3,0,1,1
1,0,1,0,0,0,0,0,0,1,0,1,0,0,0
0,1,1,0,0,0,0,0,0,0,1,1,0,0,0
0,1,1,0,0,0,0,0,0,0,1,1,0,0,0
2,0,2,0,0,0,0,0,0,2,0,2,0,0,0
2,7,9,0,0,0,0,0,0,1,3,4,1,4,5
0,5,5,0,0,0,0,0,0,0,4,4,0,1,1
0,2,2,0,0,0,0,0,0,0,2,2,0,0,0
0,32,32,0,0,0,0,0,0,0,26,26,0,6,6
0,1,1,0,0,0,0,0,0,0,1,1,0,0,0
0,25,25,0,0,0,0,0,0,0,21,21,0,4,4
0,6,6,0,0,0,0,0,0,0,5,5,0,1,1
7,0,7,0,0,0,0,0,0,5,0,5,2,0,2
1,0,1,0,0,0,0,0,0,1,0,1,0,0,0
3,2,5,0,0,0,0,0,0,3,2,5,0,0,0
1,1,2,0,0,0,0,0,0,1,1,2,0,0,0
0,1,1,0,0,0,0,0,0,0,1,1,0,0,0
0,1,1,0,0,0,0,0,0,0,1,1,0,0,0
0,1,1,0,0,0,0,0,0,0,1,1,0,0,0
0,1,1,0,0,0,0,0,0,0,1,1,0,0,0
42,106,148,0,0,0,0,0,0,40,94,134,2,12,14
0,3,3,0,0,0,0,0,0,0,3,3,0,0,0
2,5,7,0,0,0,0,0,0,2,5,7,0,0,0
4,20,24,0,0,0,0,0,0,4,20,24,0,0,0
0,2,2,0,0,0,0,0,0,0,2,2,0,0,0
5,4,9,0,0,0,0,0,0,4,2,6,1,2,3
3,0,3,0,0,0,0,0,0,1,0,1,2,0,2
1,5,6,0,0,0,0,0,0,0,5,5,1,0,1
5,4,9,0,0,0,0,0,0,5,4,9,0,0,0
0,3,3,0,0,0,0,0,0,0,3,3,0,0,0
1,0,1,0,0,0,0,0,0,1,0,1,0,0,0
1,1,2,0,0,0,0,0,0,1,1,2,0,0,0
0,1,1,0,0,0,0,0,0,0,1,1,0,0,0
7,48,55,0,0,0,0,0,0,7,48,55,0,0,0
1,0,1,0,0,0,0,0,0,1,0,1,0,0,0
0,1,1,0,0,0,0,0,0,0,1,1,0,0,0
0,1,1,0,0,0,0,0,0,0,1,1,0,0,0
0,1,1,0,0,0,0,0,0,0,1,1,0,0,0
0,1,1,0,0,0,0,0,0,0,1,1,0,0,0
0,1,1,0,0,0,0,0,0,0,1,1,0,0,0
0,1,1,0,0,0,0,0,0,0,1,1,0,0,0
1,2,3,0,0,0,0,0,0,1,2,3,0,0,0
0,17,17,0,0,0,0,0,0,0,12,12,0,5,5
0,1,1,0,0,0,0,0,0,0,1,1,0,0,0
0,2,2,0,0,0,0,0,0,0,2,2,0,0,0
0,4,4,0,0,0,0,0,0,0,4,4,0,0,0
0,2,2,0,0,0,0,0,0,0,2,2,0,0,0
0,5,5,0,0,0,0,0,0,0,5,5,0,0,0
1,5,6,0,0,0,0,0,0,1,2,3,0,3,3
0,2,2,0,0,0,0,0,0,0,1,1,0,1,1
0,1,1,0,0,0,0,0,0,0,1,1,0,0,0
0,1,1,0,0,0,0,0,0,0,1,1,0,0,0
0,1,1,0,0,0,0,0,0,0,1,1,0,0,0
13,20,33,0,0,0,0,0,0,7,13,20,6,7,13
0,1,1,0,0,0,0,0,0,0,1,1,0,0,0
0,1,1,0,0,0,0,0,0,0,1,1,0,0,0
0,2,2,0,0,0,0,0,0,0,2,2,0,0,0
1,0,1,0,0,0,0,0,0,1,0,1,0,0,0
1,0,1,0,0,0,0,0,0,1,0,1,0,0,0
0,1,1,0,0,0,0,0,0,0,1,1,0,0,0
146,200,346,1,0,1,0,0,0,55,72,127,91,128,219
1,1,2,0,0,0,0,0,0,1,1,2,0,0,0
3,1,4,0,0,0,0,0,0,3,1,4,0,0,0
1,0,1,0,0,0,0,0,0,1,0,1,0,0,0
2,6,8,0,0,0,0,0,0,2,6,8,0,0,0
1,1,2,0,0,0,0,0,0,1,1,2,0,0,0
1,3,4,0,0,0,0,0,0,1,3,4,0,0,0
3,1,4,0,0,0,0,0,0,3,1,4,0,0,0
4,8,12,0,0,0,0,0,0,4,8,12,0,0,0
4,2,6,0,0,0,0,0,0,4,1,5,0,1,1
0,1,1,0,0,0,0,0,0,0,1,1,0,0,0
4,2,6,0,0,0,0,0,0,4,2,6,0,0,0
0,2,2,0,0,0,0,0,0,0,2,2,0,0,0
41,52,93,0,0,0,0,0,0,28,36,64,13,16,29
2,2,4,0,0,0,0,0,0,1,1,2,1,1,2
2,1,3,0,0,0,0,0,0,1,1,2,1,0,1
2,0,2,0,0,0,0,0,0,2,0,2,0,0,0
2,5,7,0,0,0,0,0,0,2,5,7,0,0,0
3,3,6,0,0,0,0,0,0,3,3,6,0,0,0
0,1,1,0,0,0,0,0,0,0,1,1,0,0,0
0,1,1,0,0,0,0,0,0,0,1,1,0,0,0
0,10,10,0,0,0,0,0,0,0,9,9,0,1,1
0,6,6,0,0,0,0,0,0,0,4,4,0,2,2
0,1,1,0,0,0,0,0,0,0,1,1,0,0,0
1,0,1,0,0,0,0,0,0,1,0,1,0,0,0
0,2,2,0,0,0,0,0,0,0,2,2,0,0,0
1,0,1,0,0,0,0,0,0,1,0,1,0,0,0
22,13,35,0,0,0,0,0,0,14,10,24,8,3,11
0,1,1,0,0,0,0,0,0,0,1,1,0,0,0
1,2,3,0,0,0,0,0,0,0,2,2,1,0,1
1,2,3,0,0,0,0,0,0,1,2,3,0,0,0
0,2,2,0,0,0,0,0,0,0,2,2,0,0,0
1,1,2,0,0,0,0,0,0,1,1,2,0,0,0
3,3,6,0,0,0,0,0,0,3,3,6,0,0,0
1,3,4,0,0,0,0,0,0,1,2,3,0,1,1
0,1,1,0,0,0,0,0,0,0,1,1,0,0,0
8,14,22,1,0,1,0,0,0,8,13,21,0,1,1
2,0,2,0,0,0,0,0,0,2,0,2,0,0,0
34,35,69,0,0,0,0,0,0,28,31,59,6,4,10
3,8,11,0,0,0,0,0,0,3,7,10,0,1,1
0,1,1,0,0,0,0,0,0,0,1,1,0,0,0
0,2,2,0,0,0,0,0,0,0,2,2,0,0,0
0,1,1,0,0,0,0,0,0,0,1,1,0,0,0
1,0,1,0,0,0,0,0,0,1,0,1,0,0,0
0,1,1,0,0,0,0,0,0,0,1,1,0,0,0
3,1,4,0,0,0,0,0,0,2,1,3,1,0,1
1,0,1,0,0,0,0,0,0,1,0,1,0,0,0
0,3,3,0,0,0,0,0,0,0,2,2,0,1,1
0,1,1,0,0,0,0,0,0,0,0,0,0,1,1
0,2,2,0,0,0,0,0,0,0,2,2,0,0,0
1,0,1,0,0,0,0,0,0,0,0,0,1,0,1
0,1,1,0,0,0,0,0,0,0,1,1,0,0,0
2,2,4,0,0,0,0,0,0,2,1,3,0,1,1
0,1,1,0,0,0,0,0,0,0,1,1,0,0,0
0,2,2,0,0,0,0,0,0,0,1,1,0,1,1
1,0,1,0,0,0,0,0,0,1,0,1,0,0,0
1,5,6,0,0,0,0,0,0,1,5,6,0,0,0
1,1,2,0,0,0,0,0,0,1,1,2,0,0,0
0,1,1,0,0,0,0,0,0,0,1,1,0,0,0
6,12,18,0,0,0,0,0,0,5,12,17,1,0,1
7,13,20,0,0,0,0,0,0,7,12,19,0,1,1
3,6,9,0,0,0,0,0,0,3,6,9,0,0,0
1,1,2,0,0,0,0,0,0,1,1,2,0,0,0
1,2,3,0,0,0,0,0,0,1,2,3,0,0,0
0,2,2,0,0,0,0,0,0,0,2,2,0,0,0
1,0,1,0,0,0,0,0,0,1,0,1,0,0,0
1,0,1,0,0,0,0,0,0,1,0,1,0,0,0
2,0,2,0,0,0,0,0,0,2,0,2,0,0,0
0,1,1,0,0,0,0,0,0,0,1,1,0,0,0
13,22,35,0,0,0,0,0,0,12,22,34,1,0,1
0,1,1,0,0,0,0,0,0,0,1,1,0,0,0
1,0,1,0,0,0,0,0,0,1,0,1,0,0,0
2,5,7,0,0,0,0,0,0,2,5,7,0,0,0
2,0,2,0,0,0,0,0,0,2,0,2,0,0,0
35,25,60,0,0,0,0,0,0,14,10,24,21,15,36
10,5,15,0,0,0,0,0,0,6,3,9,4,2,6
1,2,3,0,0,0,0,0,0,1,2,3,0,0,0
10,12,22,0,0,0,0,0,0,9,8,17,1,4,5
2,3,5,0,0,0,0,0,0,2,3,5,0,0,0
0,1,1,0,0,0,0,0,0,0,1,1,0,0,0
0,2,2,0,0,0,0,0,0,0,2,2,0,0,0
1,1,2,0,0,0,0,0,0,1,1,2,0,0,0
0,2,2,0,0,0,0,0,0,0,1,1,0,1,1
0,1,1,0,0,0,0,0,0,0,1,1,0,0,0
0,1,1,0,0,0,0,0,0,0,1,1,0,0,0
2,1,3,0,0,0,0,0,0,2,1,3,0,0,0
0,1,1,0,0,0,0,0,0,0,1,1,0,0,0
0,1,1,0,0,0,0,0,0,0,1,1,0,0,0
1,0,1,0,0,0,0,0,0,1,0,1,0,0,0
0,1,1,0,0,0,0,0,0,0,1,1,0,0,0
1,0,1,0,0,0,0,0,0,1,0,1,0,0,0
2,0,2,0,0,0,0,0,0,1,0,1,1,0,1
0,1,1,0,0,0,0,0,0,0,1,1,0,0,0
0,1,1,0,0,0,0,0,0,0,1,1,0,0,0
0,1,1,0,0,0,0,0,0,0,1,1,0,0,0
1,4,5,0,0,0,0,0,0,1,4,5,0,0,0
0,1,1,0,0,0,0,0,0,0,1,1,0,0,0
0,2,2,0,0,0,0,0,0,0,2,2,0,0,0
0,6,6,0,0,0,0,0,0,0,5,5,0,1,1
2,7,9,0,0,0,0,0,0,2,7,9,0,0,0
0,1,1,0,0,0,0,0,0,0,1,1,0,0,0
1,1,2,0,0,0,0,0,0,1,1,2,0,0,0
3,0,3,0,0,0,0,0,0,2,0,2,1,0,1
0,1,1,0,0,0,0,0,0,0,1,1,0,0,0
0,1,1,0,0,0,0,0,0,0,1,1,0,0,0
1,0,1,0,0,0,0,0,0,1,0,1,0,0,0
14,25,39,0,0,0,0,0,0,14,24,38,0,1,1
1,0,1,0,0,0,0,0,0,1,0,1,0,0,0
6,10,16,0,0,0,0,0,0,2,7,9,4,3,7
1,1,2,0,0,0,0,0,0,1,1,2,0,0,0
0,1,1,0,0,0,0,0,0,0,1,1,0,0,0
0,1,1,0,0,0,0,0,0,0,1,1,0,0,0
1,0,1,0,0,0,0,0,0,1,0,1,0,0,0
14,21,35,0,0,0,0,0,0,12,15,27,2,6,8
1,1,2,0,0,0,0,0,0,1,1,2,0,0,0
7,1,8,0,0,0,0,0,0,4,1,5,3,0,3
0,1,1,0,0,0,0,0,0,0,1,1,0,0,0
0,1,1,0,0,0,0,0,0,0,1,1,0,0,0
0,1,1,0,0,0,0,0,0,0,1,1,0,0,0
1,0,1,0,0,0,0,0,0,1,0,1,0,0,0
2,0,2,0,0,0,0,0,0,2,0,2,0,0,0
1,0,1,0,0,0,0,0,0,1,0,1,0,0,0
1,0,1,0,0,0,0,0,0,1,0,1,0,0,0
1,0,1,0,0,0,0,0,0,1,0,1,0,0,0
1,0,1,0,0,0,0,0,0,1,0,1,0,0,0
0,1,1,0,0,0,0,0,0,0,1,1,0,0,0
98,97,195,0,0,0,0,0,0,96,94,190,2,3,5
2,2,4,0,0,0,0,0,0,2,2,4,0,0,0
15,19,34,0,0,0,0,0,0,15,19,34,0,0,0
6,11,17,0,0,0,0,0,0,6,11,17,0,0,0
1,2,3,0,0,0,0,0,0,1,2,3,0,0,0
2,1,3,0,0,0,0,0,0,2,1,3,0,0,0
8,12,20,0,0,0,0,0,0,8,12,20,0,0,0
0,1,1,0,0,0,0,0,0,0,1,1,0,0,0
0,1,1,0,0,0,0,0,0,0,1,1,0,0,0
0,1,1,0,0,0,0,0,0,0,1,1,0,0,0
0,1,1,0,0,0,0,0,0,0,1,1,0,0,0
1,1,2,0,0,0,0,0,0,1,1,2,0,0,0
2,0,2,0,0,0,0,0,0,2,0,2,0,0,0
1,0,1,0,0,0,0,0,0,1,0,1,0,0,0
0,1,1,0,0,0,0,0,0,0,1,1,0,0,0
0,1,1,0,0,0,0,0,0,0,1,1,0,0,0
0,1,1,0,0,0,0,0,0,0,1,1,0,0,0
0,1,1,0,0,0,0,0,0,0,1,1,0,0,0
20,41,61,0,0,0,0,0,0,19,39,58,1,2,3
10,17,27,0,0,0,0,0,0,9,17,26,1,0,1
2,3,5,0,0,0,0,0,0,2,3,5,0,0,0
22,18,40,0,0,0,0,0,0,20,16,36,2,2,4
3,4,7,0,0,0,0,0,0,3,4,7,0,0,0
0,1,1,0,0,0,0,0,0,0,1,1,0,0,0
0,1,1,0,0,0,0,0,0,0,1,1,0,0,0
0,1,1,0,0,0,0,0,0,0,1,1,0,0,0
2,3,5,0,0,0,0,0,0,2,3,5,0,0,0
3,4,7,0,0,0,0,0,0,3,3,6,0,1,1
1,1,2,0,0,0,0,0,0,1,1,2,0,0,0
1,1,2,0,0,0,0,0,0,1,1,2,0,0,0
1,2,3,0,0,0,0,0,0,1,2,3,0,0,0
3,4,7,0,0,0,0,0,0,3,4,7,0,0,0
1,10,11,0,0,0,0,0,0,1,10,11,0,0,0
1,0,1,0,0,0,0,0,0,1,0,1,0,0,0
5,5,10,0,0,0,0,0,0,5,5,10,0,0,0
0,1,1,0,0,0,0,0,0,0,1,1,0,0,0
4,2,6,0,0,0,0,0,0,4,2,6,0,0,0
1,0,1,0,0,0,0,0,0,1,0,1,0,0,0
17,9,26,0,0,0,0,0,0,16,9,25,1,0,1
17,9,26,0,0,0,0,0,0,17,9,26,0,0,0
21,16,37,0,0,0,0,0,0,21,15,36,0,1,1
1,2,3,0,0,0,0,0,0,1,2,3,0,0,0
0,2,2,0,0,0,0,0,0,0,2,2,0,0,0
3,6,9,0,0,0,0,0,0,3,6,9,0,0,0
4,4,8,0,0,0,0,0,0,4,4,8,0,0,0
51,51,102,0,0,0,0,0,0,46,46,92,5,5,10
2,0,2,0,0,0,0,0,0,2,0,2,0,0,0
2,2,4,0,0,0,0,0,0,2,1,3,0,1,1
3,0,3,0,0,0,0,0,0,3,0,3,0,0,0
3,3,6,0,0,0,0,0,0,3,3,6,0,0,0
1,0,1,0,0,0,0,0,0,1,0,1,0,0,0
0,1,1,0,0,0,0,0,0,0,1,1,0,0,0
0,1,1,0,0,0,0,0,0,0,1,1,0,0,0
0,3,3,0,0,0,0,0,0,0,3,3,0,0,0
1,0,1,0,0,0,0,0,0,1,0,1,0,0,0
0,1,1,0,0,0,0,0,0,0,1,1,0,0,0
0,1,1,0,0,0,0,0,0,0,1,1,0,0,0
0,6,6,0,0,0,0,0,0,0,4,4,0,2,2
1,0,1,0,0,0,0,0,0,1,0,1,0,0,0
2,0,2,0,0,0,0,0,0,2,0,2,0,0,0
0,2,2,0,0,0,0,0,0,0,2,2,0,0,0
1,0,1,0,0,0,0,0,0,1,0,1,0,0,0
1,0,1,0,0,0,0,0,0,1,0,1,0,0,0
0,1,1,0,0,0,0,0,0,0,1,1,0,0,0
0,1,1,0,0,0,0,0,0,0,1,1,0,0,0
1,0,1,0,0,0,0,0,0,1,0,1,0,0,0
0,4,4,0,0,0,0,0,0,0,4,4,0,0,0
2,1,3,0,0,0,0,0,0,2,1,3,0,0,0
18,4,22,0,0,0,0,0,0,4,1,5,14,3,17
0,1,1,0,0,0,0,0,0,0,1,1,0,0,0
0,1,1,0,0,0,0,0,0,0,1,1,0,0,0
0,1,1,0,0,0,0,0,0,0,1,1,0,0,0
1,0,1,0,0,0,0,0,0,1,0,1,0,0,0
473,740,1213,1,0,1,0,0,0,134,240,374,339,500,839
3,8,11,0,0,0,0,0,0,3,7,10,0,1,1
1,2,3,0,0,0,0,0,0,1,2,3,0,0,0
0,1,1,0,0,0,0,0,0,0,1,1,0,0,0
1,1,2,0,0,0,0,0,0,1,1,2,0,0,0
0,1,1,0,0,0,0,0,0,0,1,1,0,0,0
1,8,9,0,0,0,0,0,0,1,8,9,0,0,0
1,1,2,0,0,0,0,0,0,1,1,2,0,0,0
3,7,10,0,0,0,0,0,0,3,6,9,0,1,1
1,1,2,0,0,0,0,0,0,1,1,2,0,0,0
6,6,12,0,0,0,0,0,0,5,6,11,1,0,1
1,0,1,0,0,0,0,0,0,1,0,1,0,0,0
3,1,4,0,0,0,0,0,0,3,1,4,0,0,0
0,3,3,0,0,0,0,0,0,0,3,3,0,0,0
1,0,1,0,0,0,0,0,0,1,0,1,0,0,0
0,1,1,0,0,0,0,0,0,0,1,1,0,0,0
0,1,1,0,0,0,0,0,0,0,1,1,0,0,0
1,0,1,0,0,0,0,0,0,1,0,1,0,0,0
1,0,1,0,0,0,0,0,0,1,0,1,0,0,0
0,1,1,0,0,0,0,0,0,0,1,1,0,0,0
1,2,3,0,0,0,0,0,0,1,2,3,0,0,0
0,1,1,0,0,0,0,0,0,0,1,1,0,0,0
0,1,1,0,0,0,0,0,0,0,1,1,0,0,0
2,2,4,0,0,0,0,0,0,2,2,4,0,0,0
6,4,10,0,0,0,0,0,0,3,1,4,3,3,6
6,6,12,0,0,0,0,0,0,3,5,8,3,1,4
1,0,1,0,0,0,0,0,0,1,0,1,0,0,0
4,5,9,0,0,0,0,0,0,1,5,6,3,0,3
1,0,1,0,0,0,0,0,0,1,0,1,0,0,0
0,1,1,0,0,0,0,0,0,0,1,1,0,0,0
0,3,3,0,0,0,0,0,0,0,3,3,0,0,0
0,1,1,0,0,0,0,0,0,0,1,1,0,0,0
0,1,1,0,0,0,0,0,0,0,1,1,0,0,0
1,0,1,0,0,0,0,0,0,0,0,0,1,0,1
4,1,5,0,0,0,0,0,0,4,1,5,0,0,0
1,0,1,0,0,0,0,0,0,1,0,1,0,0,0
5,4,9,2,0,2,0,0,0,3,2,5,2,2,4
1,0,1,0,0,0,0,0,0,1,0,1,0,0,0
2,0,2,0,0,0,0,0,0,1,0,1,1,0,1
1,0,1,0,0,0,0,0,0,1,0,1,0,0,0
1,0,1,0,0,0,0,0,0,1,0,1,0,0,0
0,2,2,0,0,0,0,0,0,0,2,2,0,0,0
2,4,6,0,0,0,0,0,0,2,2,4,0,2,2
1,0,1,0,0,0,0,0,0,1,0,1,0,0,0
0,1,1,0,0,0,0,0,0,0,1,1,0,0,0
4,4,8,0,0,0,0,0,0,4,4,8,0,0,0
2,0,2,0,0,0,0,0,0,2,0,2,0,0,0
0,1,1,0,0,0,0,0,0,0,1,1,0,0,0
16,19,35,0,0,0,0,0,0,14,14,28,2,5,7
0,1,1,0,0,0,0,0,0,0,1,1,0,0,0
0,2,2,0,0,0,0,0,0,0,2,2,0,0,0
0,1,1,0,0,0,0,0,0,0,1,1,0,0,0
3,1,4,0,0,0,0,0,0,2,1,3,1,0,1
1,0,1,0,0,0,0,0,0,1,0,1,0,0,0
2,1,3,0,0,0,0,0,0,2,1,3,0,0,0
1,0,1,0,0,0,0,0,0,1,0,1,0,0,0
0,1,1,0,0,0,0,0,0,0,1,1,0,0,0
1,0,1,0,0,0,0,0,0,1,0,1,0,0,0
1,0,1,0,0,0,0,0,0,1,0,1,0,0,0
1,0,1,0,0,0,0,0,0,1,0,1,0,0,0
2,0,2,1,0,1,0,0,0,2,0,2,0,0,0
3,5,8,0,0,0,0,0,0,3,4,7,0,1,1
71,82,153,0,0,0,0,0,0,70,80,150,1,2,3
14,17,31,0,0,0,0,0,0,14,17,31,0,0,0
0,4,4,0,0,0,0,0,0,0,4,4,0,0,0
1,0,1,0,0,0,0,0,0,1,0,1,0,0,0
38,59,97,0,0,0,0,0,0,37,58,95,1,1,2
22,29,51,0,0,0,0,0,0,21,29,50,1,0,1
1,1,2,0,0,0,0,0,0,1,1,2,0,0,0
17,30,47,0,0,0,0,0,0,15,29,44,2,1,3
383,380,763,0,0,0,0,0,0,318,318,636,65,62,127
2,1,3,0,0,0,0,0,0,2,1,3,0,0,0
84,202,286,0,0,0,0,0,0,81,191,272,3,11,14
5,5,10,0,0,0,0,0,0,5,5,10,0,0,0
0,2,2,0,0,0,0,0,0,0,2,2,0,0,0
0,1,1,0,0,0,0,0,0,0,1,1,0,0,0
0,3,3,0,0,0,0,0,0,0,2,2,0,1,1
41,72,113,0,0,0,0,0,0,40,69,109,1,3,4
4,4,8,0,0,0,0,0,0,4,4,8,0,0,0
49,68,117,0,0,0,0,0,0,48,67,115,1,1,2
322,455,777,0,0,0,0,0,0,285,394,679,37,61,98
0,2,2,0,0,0,0,0,0,0,2,2,0,0,0
1,4,5,0,0,0,0,0,0,1,4,5,0,0,0
0,1,1,0,0,0,0,0,0,0,1,1,0,0,0
7,15,22,0,0,0,0,0,0,7,15,22,0,0,0
2,6,8,0,0,0,0,0,0,2,6,8,0,0,0
24,29,53,0,0,0,0,0,0,24,29,53,0,0,0
3,0,3,0,0,0,0,0,0,3,0,3,0,0,0
9,7,16,0,0,0,0,0,0,9,6,15,0,1,1
4,1,5,0,0,0,0,0,0,4,1,5,0,0,0
1,1,2,0,0,0,0,0,0,1,1,2,0,0,0
0,1,1,0,0,0,0,0,0,0,1,1,0,0,0
7,3,10,0,0,0,0,0,0,5,3,8,2,0,2
437,379,816,0,0,0,0,0,0,361,323,684,76,56,132
0,1,1,0,0,0,0,0,0,0,1,1,0,0,0
1,1,2,0,0,0,0,0,0,1,1,2,0,0,0
1,1,2,0,0,0,0,0,0,1,1,2,0,0,0
3,4,7,0,0,0,0,0,0,3,4,7,0,0,0
0,1,1,0,0,0,0,0,0,0,1,1,0,0,0
1,4,5,0,0,0,0,0,0,1,4,5,0,0,0
15,33,48,0,0,0,0,0,0,15,33,48,0,0,0
1595,1414,3009,0,0,0,0,0,0,946,879,1825,649,535,1184
2,0,2,0,0,0,0,0,0,2,0,2,0,0,0
1,2,3,0,0,0,0,0,0,1,2,3,0,0,0
8,7,15,0,0,0,0,0,0,8,7,15,0,0,0
39,61,100,0,0,0,0,0,0,38,61,99,1,0,1
1,1,2,0,0,0,0,0,0,1,1,2,0,0,0
2,1,3,0,0,0,0,0,0,2,1,3,0,0,0
21,40,61,0,0,0,0,0,0,19,36,55,2,4,6
100,109,209,0,0,0,0,0,0,91,107,198,9,2,11
5,3,8,0,0,0,0,0,0,5,3,8,0,0,0
4,8,12,0,0,0,0,0,0,4,8,12,0,0,0
1,0,1,0,0,0,0,0,0,1,0,1,0,0,0
2,3,5,0,0,0,0,0,0,2,3,5,0,0,0
0,1,1,0,0,0,0,0,0,0,1,1,0,0,0
0,1,1,0,0,0,0,0,0,0,1,1,0,0,0
1,0,1,0,0,0,0,0,0,1,0,1,0,0,0
6,6,12,0,0,0,0,0,0,5,5,10,1,1,2
1,1,2,0,0,0,0,0,0,1,1,2,0,0,0
5,9,14,0,0,0,0,0,0,4,8,12,1,1,2
16,29,45,0,0,0,0,0,0,10,22,32,6,7,13
3,6,9,0,0,0,0,0,0,3,6,9,0,0,0
57,44,101,0,0,0,0,0,0,46,33,79,11,11,22
35,29,64,0,0,0,0,0,0,29,20,49,6,9,15
4,1,5,0,0,0,0,0,0,4,1,5,0,0,0
3,5,8,0,0,0,0,0,0,3,5,8,0,0,0
0,1,1,0,0,0,0,0,0,0,1,1,0,0,0
113,160,273,0,0,0,0,0,0,99,141,240,14,19,33
0,2,2,0,0,0,0,0,0,0,2,2,0,0,0
12,25,37,0,0,0,0,0,0,11,24,35,1,1,2
10,9,19,0,0,0,0,0,0,10,9,19,0,0,0
52,102,154,0,0,0,0,0,0,47,95,142,5,7,12
96,88,184,0,0,0,0,0,0,87,85,172,9,3,12
3,0,3,0,0,0,0,0,0,3,0,3,0,0,0
1,3,4,0,0,0,0,0,0,1,3,4,0,0,0
2,0,2,0,0,0,0,0,0,2,0,2,0,0,0
33,68,101,0,0,0,0,0,0,23,47,70,10,21,31
1,2,3,0,0,0,0,0,0,1,2,3,0,0,0
0,1,1,0,0,0,0,0,0,0,1,1,0,0,0
26,27,53,0,0,0,0,0,0,22,25,47,4,2,6
2,0,2,0,0,0,0,0,0,2,0,2,0,0,0
0,1,1,0,0,0,0,0,0,0,1,1,0,0,0
1,1,2,0,0,0,0,0,0,1,1,2,0,0,0
0,1,1,0,0,0,0,0,0,0,1,1,0,0,0
1,2,3,0,0,0,0,0,0,1,2,3,0,0,0
1,0,1,0,0,0,0,0,0,1,0,1,0,0,0
1,0,1,0,0,0,0,0,0,1,0,1,0,0,0
2,0,2,0,0,0,0,0,0,2,0,2,0,0,0
1,0,1,0,0,0,0,0,0,1,0,1,0,0,0
1,0,1,0,0,0,0,0,0,1,0,1,0,0,0
0,1,1,0,0,0,0,0,0,0,1,1,0,0,0
5,2,7,0,0,0,0,0,0,5,2,7,0,0,0
0,1,1,0,0,0,0,0,0,0,1,1,0,0,0
0,1,1,0,0,0,0,0,0,0,1,1,0,0,0
3,0,3,0,0,0,0,0,0,3,0,3,0,0,0
3,2,5,0,0,0,0,0,0,3,2,5,0,0,0
2,0,2,0,0,0,0,0,0,2,0,2,0,0,0
5,8,13,0,0,0,0,0,0,5,8,13,0,0,0
8,18,26,0,0,0,0,0,0,8,18,26,0,0,0
13,18,31,0,0,0,0,0,0,12,17,29,1,1,2
45,52,97,0,0,0,0,0,0,41,48,89,4,4,8
1,1,2,0,0,0,0,0,0,1,1,2,0,0,0
1,0,1,0,0,0,0,0,0,1,0,1,0,0,0
2,1,3,0,0,0,0,0,0,2,1,3,0,0,0
1,3,4,0,0,0,0,0,0,1,3,4,0,0,0
29,59,88,0,0,0,0,0,0,19,41,60,10,18,28
23,17,40,0,0,0,0,0,0,19,13,32,4,4,8
90,167,257,0,0,0,0,0,0,44,103,147,46,64,110
1,3,4,0,0,0,0,0,0,1,3,4,0,0,0
1,0,1,0,0,0,0,0,0,1,0,1,0,0,0
3,0,3,0,0,0,0,0,0,3,0,3,0,0,0
4,1,5,0,0,0,0,0,0,4,1,5,0,0,0
1,0,1,0,0,0,0,0,0,1,0,1,0,0,0
2,0,2,0,0,0,0,0,0,2,0,2,0,0,0
1,1,2,0,0,0,0,0,0,1,1,2,0,0,0
3,1,4,0,0,0,0,0,0,3,1,4,0,0,0
26,13,39,0,0,0,0,0,0,25,13,38,1,0,1
7,1,8,0,0,0,0,0,0,7,1,8,0,0,0
2,1,3,0,0,0,0,0,0,2,1,3,0,0,0
13,8,21,0,0,0,0,0,0,11,8,19,2,0,2
1,2,3,0,0,0,0,0,0,1,2,3,0,0,0
2,1,3,0,0,0,0,0,0,2,1,3,0,0,0
1,2,3,0,0,0,0,0,0,1,2,3,0,0,0
0,1,1,0,0,0,0,0,0,0,1,1,0,0,0
1,1,2,0,0,0,0,0,0,1,1,2,0,0,0
1,5,6,0,0,0,0,0,0,1,5,6,0,0,0
12,14,26,0,0,0,0,0,0,11,13,24,1,1,2
1,3,4,0,0,0,0,0,0,1,3,4,0,0,0
18,36,54,0,0,0,0,0,0,18,31,49,0,5,5
1,4,5,0,0,0,0,0,0,1,3,4,0,1,1
0,2,2,0,0,0,0,0,0,0,2,2,0,0,0
0,1,1,0,0,0,0,0,0,0,1,1,0,0,0
1,0,1,0,0,0,0,0,0,1,0,1,0,0,0
1,1,2,0,0,0,0,0,0,1,1,2,0,0,0
0,1,1,0,0,0,0,0,0,0,1,1,0,0,0
2,0,2,0,0,0,0,0,0,2,0,2,0,0,0
2,0,2,0,0,0,0,0,0,2,0,2,0,0,0
1,0,1,0,0,0,0,0,0,1,0,1,0,0,0
1,0,1,0,0,0,0,0,0,1,0,1,0,0,0
2,1,3,0,0,0,0,0,0,2,1,3,0,0,0
6,1,7,0,0,0,0,0,0,6,1,7,0,0,0
3,3,6,0,0,0,0,0,0,3,3,6,0,0,0
3,1,4,0,0,0,0,0,0,3,1,4,0,0,0
0,1,1,0,0,0,0,0,0,0,1,1,0,0,0
0,1,1,0,0,0,0,0,0,0,1,1,0,0,0
1,0,1,0,0,0,0,0,0,1,0,1,0,0,0
1,0,1,0,0,0,0,0,0,1,0,1,0,0,0
5,1,6,0,0,0,0,0,0,5,1,6,0,0,0
1,1,2,0,0,0,0,0,0,1,1,2,0,0,0
1,1,2,0,0,0,0,0,0,1,1,2,0,0,0
0,1,1,0,0,0,0,0,0,0,1,1,0,0,0
1,8,9,0,0,0,0,0,0,1,8,9,0,0,0
0,2,2,0,0,0,0,0,0,0,1,1,0,1,1
18,32,50,0,0,0,0,0,0,18,30,48,0,2,2
15,33,48,0,0,0,0,0,0,14,30,44,1,3,4
1,0,1,0,0,0,0,0,0,1,0,1,0,0,0
0,2,2,0,0,0,0,0,0,0,2,2,0,0,0
28,71,99,1,0,1,0,0,0,25,62,87,3,9,12
4,3,7,0,0,0,0,0,0,4,3,7,0,0,0
5,3,8,0,0,0,0,0,0,5,3,8,0,0,0
1,3,4,0,0,0,0,0,0,1,3,4,0,0,0
11,37,48,0,1,1,0,0,0,9,35,44,2,2,4
45,82,127,0,0,0,0,0,0,42,78,120,3,4,7
146,297,443,0,0,0,0,0,0,122,247,369,24,50,74
3,8,11,0,0,0,0,0,0,3,7,10,0,1,1
2,9,11,0,0,0,0,0,0,2,9,11,0,0,0
2,1,3,0,0,0,0,0,0,2,1,3,0,0,0
0,1,1,0,0,0,0,0,0,0,1,1,0,0,0
1,0,1,0,0,0,0,0,0,1,0,1,0,0,0
1,0,1,0,0,0,0,0,0,1,0,1,0,0,0
0,1,1,0,0,0,0,0,0,0,1,1,0,0,0
3,2,5,0,0,0,0,0,0,3,1,4,0,1,1
0,1,1,0,0,0,0,0,0,0,1,1,0,0,0
0,4,4,0,0,0,0,0,0,0,4,4,0,0,0
3,7,10,0,0,0,0,0,0,3,6,9,0,1,1
1,2,3,0,0,0,0,0,0,1,2,3,0,0,0
11,0,11,0,0,0,0,0,0,8,0,8,3,0,3
1,0,1,0,0,0,0,0,0,1,0,1,0,0,0
1,0,1,0,0,0,0,0,0,1,0,1,0,0,0
5,7,12,0,0,0,0,0,0,3,7,10,2,0,2
1,1,2,0,0,0,0,0,0,1,1,2,0,0,0
2,2,4,0,0,0,0,0,0,1,2,3,1,0,1
3,0,3,0,0,0,0,0,0,2,0,2,1,0,1
4,7,11,0,0,0,0,0,0,2,5,7,2,2,4
0,2,2,0,0,0,0,0,0,0,2,2,0,0,0
1,2,3,0,0,0,0,0,0,1,2,3,0,0,0
5,7,12,0,0,0,0,0,0,5,7,12,0,0,0
1,1,2,0,0,0,0,0,0,1,1,2,0,0,0
1,3,4,0,0,0,0,0,0,1,3,4,0,0,0
2,5,7,0,0,0,0,0,0,2,5,7,0,0,0
1,1,2,0,0,0,0,0,0,1,1,2,0,0,0
1,1,2,0,0,0,0,0,0,1,1,2,0,0,0
0,1,1,0,0,0,0,0,0,0,1,1,0,0,0
1,0,1,0,0,0,0,0,0,1,0,1,0,0,0
1,0,1,0,0,0,0,0,0,1,0,1,0,0,0
28,23,51,0,0,0,0,0,0,24,23,47,4,0,4
98,63,161,0,0,0,0,0,0,97,61,158,1,2,3
0,1,1,0,0,0,0,0,0,0,1,1,0,0,0
2,7,9,0,0,0,0,0,0,1,5,6,1,2,3
4,2,6,0,0,0,0,0,0,4,2,6,0,0,0
2,0,2,0,0,0,0,0,0,2,0,2,0,0,0
3,0,3,0,0,0,0,0,0,3,0,3,0,0,0
2,1,3,0,0,0,0,0,0,2,1,3,0,0,0
0,1,1,0,0,0,0,0,0,0,1,1,0,0,0
1,0,1,0,0,0,0,0,0,1,0,1,0,0,0
1,1,2,0,0,0,0,0,0,0,1,1,1,0,1
0,1,1,0,0,0,0,0,0,0,1,1,0,0,0
0,2,2,0,0,0,0,0,0,0,2,2,0,0,0
1,0,1,0,0,0,0,0,0,1,0,1,0,0,0
1,0,1,0,0,0,0,0,0,1,0,1,0,0,0
0,2,2,0,0,0,0,0,0,0,2,2,0,0,0
1,0,1,0,0,0,0,0,0,1,0,1,0,0,0
1,1,2,0,0,0,0,0,0,1,1,2,0,0,0
2,8,10,0,0,0,0,0,0,1,6,7,1,2,3
1,1,2,0,0,0,0,0,0,1,1,2,0,0,0
0,1,1,0,0,0,0,0,0,0,1,1,0,0,0
0,2,2,0,0,0,0,0,0,0,2,2,0,0,0
1,0,1,0,0,0,0,0,0,1,0,1,0,0,0
2,0,2,0,0,0,0,0,0,1,0,1,1,0,1
0,1,1,0,0,0,0,0,0,0,1,1,0,0,0
16,19,35,0,0,0,0,0,0,16,19,35,0,0,0
0,4,4,0,0,0,0,0,0,0,4,4,0,0,0
1,2,3,0,0,0,0,0,0,1,2,3,0,0,0
4,6,10,0,0,0,0,0,0,4,5,9,0,1,1
1,1,2,0,0,0,0,0,0,1,1,2,0,0,0
2,1,3,0,0,0,0,0,0,2,1,3,0,0,0
1,2,3,0,0,0,0,0,0,1,2,3,0,0,0
1,1,2,0,0,0,0,0,0,1,1,2,0,0,0
3,5,8,0,0,0,0,0,0,3,4,7,0,1,1
2,5,7,0,0,0,0,0,0,2,4,6,0,1,1
2,0,2,0,0,0,0,0,0,2,0,2,0,0,0
22,20,42,1,0,1,0,0,0,22,20,42,0,0,0
3,10,13,0,0,0,0,0,0,3,9,12,0,1,1
4,9,13,0,0,0,0,0,0,4,9,13,0,0,0
0,2,2,0,0,0,0,0,0,0,2,2,0,0,0
3,3,6,0,0,0,0,0,0,3,3,6,0,0,0
0,1,1,0,0,0,0,0,0,0,1,1,0,0,0
58,29,87,0,0,0,0,0,0,54,27,81,4,2,6
0,1,1,0,0,0,0,0,0,0,1,1,0,0,0
2,0,2,0,0,0,0,0,0,2,0,2,0,0,0
23,28,51,0,0,0,0,0,0,23,27,50,0,1,1
1,4,5,0,0,0,0,0,0,1,4,5,0,0,0
0,3,3,0,0,0,0,0,0,0,2,2,0,1,1
0,1,1,0,0,0,0,0,0,0,1,1,0,0,0
3,7,10,0,0,0,0,0,0,3,6,9,0,1,1
1,0,1,0,0,0,0,0,0,1,0,1,0,0,0
0,1,1,0,0,0,0,0,0,0,1,1,0,0,0
48,81,129,0,0,0,0,0,0,43,71,114,5,10,15
0,1,1,0,0,0,0,0,0,0,1,1,0,0,0
36,42,78,0,0,0,0,0,0,35,39,74,1,3,4
1,0,1,0,0,0,0,0,0,1,0,1,0,0,0
1,0,1,0,0,0,0,0,0,1,0,1,0,0,0
0,1,1,0,0,0,0,0,0,0,1,1,0,0,0
22,29,51,0,0,0,0,0,0,22,29,51,0,0,0
0,1,1,0,0,0,0,0,0,0,1,1,0,0,0
0,1,1,0,0,0,0,0,0,0,1,1,0,0,0
3,8,11,0,0,0,0,0,0,3,7,10,0,1,1
0,5,5,0,0,0,0,0,0,0,4,4,0,1,1
1,2,3,0,0,0,0,0,0,1,2,3,0,0,0
3,1,4,0,0,0,0,0,0,3,1,4,0,0,0
38,45,83,0,0,0,0,0,0,37,45,82,1,0,1
0,1,1,0,0,0,0,0,0,0,1,1,0,0,0
1,0,1,0,0,0,0,0,0,1,0,1,0,0,0
0,1,1,0,0,0,0,0,0,0,1,1,0,0,0
0,1,1,0,0,0,0,0,0,0,1,1,0,0,0
0,1,1,0,0,0,0,0,0,0,1,1,0,0,0
0,2,2,0,0,0,0,0,0,0,2,2,0,0,0
29,17,46,0,0,0,0,0,0,29,17,46,0,0,0
2,2,4,0,0,0,0,0,0,2,2,4,0,0,0
2,0,2,0,0,0,0,0,0,2,0,2,0,0,0
0,2,2,0,0,0,0,0,0,0,2,2,0,0,0
9,4,13,0,0,0,0,0,0,9,4,13,0,0,0
1,1,2,0,0,0,0,0,0,1,1,2,0,0,0
2,0,2,0,0,0,0,0,0,1,0,1,1,0,1
0,2,2,0,0,0,0,0,0,0,2,2,0,0,0
1,4,5,0,0,0,0,0,0,1,3,4,0,1,1
1,0,1,0,0,0,0,0,0,1,0,1,0,0,0
29,27,56,0,0,0,0,0,0,28,27,55,1,0,1
1,0,1,0,0,0,0,0,0,1,0,1,0,0,0
0,2,2,0,0,0,0,0,0,0,1,1,0,1,1
0,1,1,0,0,0,0,0,0,0,1,1,0,0,0
0,2,2,0,0,0,0,0,0,0,2,2,0,0,0
0,1,1,0,0,0,0,0,0,0,1,1,0,0,0
16,21,37,0,0,0,0,0,0,14,20,34,2,1,3
6,12,18,0,0,0,0,0,0,6,12,18,0,0,0
20,42,62,0,0,0,0,0,0,18,42,60,2,0,2
1,0,1,0,0,0,0,0,0,1,0,1,0,0,0
0,1,1,0,0,0,0,0,0,0,1,1,0,0,0
1,0,1,0,0,0,0,0,0,1,0,1,0,0,0
1,0,1,0,0,0,0,0,0,0,0,0,1,0,1
9,7,16,0,0,0,0,0,0,6,6,12,3,1,4
0,1,1,0,0,0,0,0,0,0,1,1,0,0,0
1,3,4,0,0,0,0,0,0,1,3,4,0,0,0
11,18,29,0,0,0,0,0,0,10,16,26,1,2,3
2,0,2,0,0,0,0,0,0,1,0,1,1,0,1
5,2,7,0,0,0,0,0,0,4,2,6,1,0,1
1,4,5,0,0,0,0,0,0,1,4,5,0,0,0
0,2,2,0,0,0,0,0,0,0,2,2,0,0,0
3,1,4,0,0,0,0,0,0,3,1,4,0,0,0
1,1,2,0,0,0,0,0,0,1,1,2,0,0,0
0,1,1,0,0,0,0,0,0,0,1,1,0,0,0
1,0,1,0,0,0,0,0,0,1,0,1,0,0,0
1,0,1,0,0,0,0,0,0,1,0,1,0,0,0
5,3,8,0,0,0,0,0,0,5,3,8,0,0,0
0,3,3,0,0,0,0,0,0,0,2,2,0,1,1
0,1,1,0,0,0,0,0,0,0,1,1,0,0,0
1,0,1,0,0,0,0,0,0,1,0,1,0,0,0
1,3,4,0,0,0,0,0,0,1,1,2,0,2,2
1,3,4,0,0,0,0,0,0,1,3,4,0,0,0
0,3,3,0,0,0,0,0,0,0,3,3,0,0,0
1,2,3,0,0,0,0,0,0,1,2,3,0,0,0
0,3,3,0,0,0,0,0,0,0,3,3,0,0,0
1,2,3,0,0,0,0,0,0,1,2,3,0,0,0
8,8,16,0,0,0,0,0,0,3,3,6,5,5,10
0,1,1,0,0,0,0,0,0,0,1,1,0,0,0
1,0,1,0,0,0,0,0,0,1,0,1,0,0,0
0,1,1,0,0,0,0,0,0,0,1,1,0,0,0
1,3,4,0,0,0,0,0,0,1,3,4,0,0,0
1,0,1,0,0,0,0,0,0,1,0,1,0,0,0
3,0,3,0,0,0,0,0,0,1,0,1,2,0,2
0,1,1,0,0,0,0,0,0,0,1,1,0,0,0
0,1,1,0,0,0,0,0,0,0,1,1,0,0,0
12,16,28,0,0,0,0,0,0,12,16,28,0,0,0
1,0,1,0,0,0,0,0,0,1,0,1,0,0,0
0,1,1,0,0,0,0,0,0,0,1,1,0,0,0
0,1,1,0,0,0,0,0,0,0,1,1,0,0,0
1,0,1,0,0,0,0,0,0,1,0,1,0,0,0
1,0,1,0,0,0,0,0,0,1,0,1,0,0,0
1,0,1,0,0,0,0,0,0,1,0,1,0,0,0
0,1,1,0,0,0,0,0,0,0,1,1,0,0,0
0,1,1,0,0,0,0,0,0,0,1,1,0,0,0
0,1,1,0,0,0,0,0,0,0,1,1,0,0,0
1,2,3,0,0,0,0,0,0,1,2,3,0,0,0
0,1,1,0,0,0,0,0,0,0,1,1,0,0,0
0,1,1,0,0,0,0,0,0,0,1,1,0,0,0
0,5,5,0,0,0,0,0,0,0,2,2,0,3,3
0,3,3,0,0,0,0,0,0,0,3,3,0,0,0
1,1,2,0,0,0,0,0,0,1,1,2,0,0,0
23,10,33,0,0,0,0,0,0,17,9,26,6,1,7
3,2,5,0,0,0,0,0,0,3,2,5,0,0,0
0,2,2,0,0,0,0,0,0,0,2,2,0,0,0
1,0,1,0,0,0,0,0,0,1,0,1,0,0,0
0,1,1,0,0,0,0,0,0,0,1,1,0,0,0
1,2,3,0,0,0,0,0,0,1,1,2,0,1,1
13,49,62,0,0,0,0,0,0,13,41,54,0,8,8
3,1,4,0,0,0,0,0,0,3,1,4,0,0,0
0,2,2,0,0,0,0,0,0,0,2,2,0,0,0
0,2,2,0,0,0,0,0,0,0,2,2,0,0,0
0,1,1,0,0,0,0,0,0,0,1,1,0,0,0
1,3,4,0,0,0,0,0,0,1,3,4,0,0,0
0,1,1,0,0,0,0,0,0,0,1,1,0,0,0
0,1,1,0,0,0,0,0,0,0,1,1,0,0,0
0,1,1,0,0,0,0,0,0,0,1,1,0,0,0
1,0,1,0,0,0,0,0,0,1,0,1,0,0,0
1,0,1,0,0,0,0,0,0,1,0,1,0,0,0
1,0,1,0,0,0,0,0,0,1,0,1,0,0,0
1,2,3,0,0,0,0,0,0,1,2,3,0,0,0
1,1,2,0,0,0,0,0,0,1,1,2,0,0,0
1,0,1,0,0,0,0,0,0,1,0,1,0,0,0
16,17,33,0,0,0,0,0,0,15,17,32,1,0,1
1,1,2,0,0,0,0,0,0,1,1,2,0,0,0
4,16,20,0,0,0,0,0,0,4,16,20,0,0,0
1,0,1,0,0,0,0,0,0,1,0,1,0,0,0
1,1,2,0,0,0,0,0,0,1,1,2,0,0,0
1,2,3,0,0,0,0,0,0,1,2,3,0,0,0
0,1,1,0,0,0,0,0,0,0,1,1,0,0,0
2,2,4,1,0,1,0,0,0,2,2,4,0,0,0
1,7,8,0,0,0,0,0,0,1,7,8,0,0,0
0,1,1,0,0,0,0,0,0,0,1,1,0,0,0
1,1,2,0,0,0,0,0,0,1,1,2,0,0,0
15,16,31,0,0,0,0,0,0,14,16,30,1,0,1
3,8,11,0,0,0,0,0,0,3,8,11,0,0,0
69,101,170,0,0,0,0,0,0,63,91,154,6,10,16
1,1,2,0,0,0,0,0,0,1,1,2,0,0,0
1,0,1,0,0,0,0,0,0,1,0,1,0,0,0
0,1,1,0,0,0,0,0,0,0,1,1,0,0,0
0,1,1,0,0,0,0,0,0,0,1,1,0,0,0
27,37,64,0,0,0,0,0,0,27,35,62,0,2,2
4,1,5,0,0,0,0,0,0,4,1,5,0,0,0
1,0,1,0,0,0,0,0,0,1,0,1,0,0,0
1,7,8,0,0,0,0,0,0,1,3,4,0,4,4
1,0,1,0,0,0,0,0,0,1,0,1,0,0,0
1,0,1,0,0,0,0,0,0,1,0,1,0,0,0
2,0,2,0,0,0,0,0,0,2,0,2,0,0,0
2,0,2,0,0,0,0,0,0,1,0,1,1,0,1
0,1,1,0,0,0,0,0,0,0,1,1,0,0,0
1,0,1,0,0,0,0,0,0,1,0,1,0,0,0
1,1,2,0,0,0,0,0,0,1,1,2,0,0,0
1,1,2,0,0,0,0,0,0,1,1,2,0,0,0
5,4,9,0,0,0,0,0,0,5,4,9,0,0,0
14,14,28,0,0,0,0,0,0,13,13,26,1,1,2
7,12,19,0,0,0,0,0,0,6,12,18,1,0,1
1,0,1,0,0,0,0,0,0,1,0,1,0,0,0
0,1,1,0,0,0,0,0,0,0,1,1,0,0,0
0,2,2,0,0,0,0,0,0,0,2,2,0,0,0
0,1,1,0,0,0,0,0,0,0,1,1,0,0,0
1,0,1,0,0,0,0,0,0,1,0,1,0,0,0
1,0,1,0,0,0,0,0,0,0,0,0,1,0,1
1,0,1,0,0,0,0,0,0,1,0,1,0,0,0
0,1,1,0,0,0,0,0,0,0,1,1,0,0,0
1,0,1,0,0,0,0,0,0,1,0,1,0,0,0
1,0,1,0,0,0,0,0,0,1,0,1,0,0,0
1,5,6,0,0,0,0,0,0,1,5,6,0,0,0
0,1,1,0,0,0,0,0,0,0,1,1,0,0,0
0,1,1,0,0,0,0,0,0,0,1,1,0,0,0
0,3,3,0,0,0,0,0,0,0,3,3,0,0,0
1,0,1,0,0,0,0,0,0,1,0,1,0,0,0
1,0,1,0,0,0,0,0,0,1,0,1,0,0,0
0,1,1,0,0,0,0,0,0,0,1,1,0,0,0
1,0,1,0,0,0,0,0,0,1,0,1,0,0,0
0,1,1,0,0,0,0,0,0,0,1,1,0,0,0
1,3,4,0,0,0,0,0,0,1,3,4,0,0,0
0,1,1,0,0,0,0,0,0,0,1,1,0,0,0
0,1,1,0,0,0,0,0,0,0,1,1,0,0,0
2,0,2,0,0,0,0,0,0,2,0,2,0,0,0
7,1,8,0,0,0,0,0,0,5,1,6,2,0,2
1,0,1,0,0,0,0,0,0,1,0,1,0,0,0
1,0,1,0,0,0,0,0,0,1,0,1,0,0,0
0,1,1,0,0,0,0,0,0,0,1,1,0,0,0
2,0,2,0,0,0,0,0,0,2,0,2,0,0,0
2,1,3,0,0,0,0,0,0,2,1,3,0,0,0
2,0,2,0,0,0,0,0,0,2,0,2,0,0,0
0,1,1,0,0,0,0,0,0,0,1,1,0,0,0
1,0,1,0,0,0,0,0,0,1,0,1,0,0,0
2,3,5,0,0,0,0,0,0,2,3,5,0,0,0
0,2,2,0,0,0,0,0,0,0,2,2,0,0,0
8,15,23,0,0,0,0,0,0,8,14,22,0,1,1
12,28,40,0,0,0,0,0,0,11,28,39,1,0,1
6,5,11,0,0,0,0,0,0,6,5,11,0,0,0
7,0,7,0,0,0,0,0,0,7,0,7,0,0,0
61,183,244,0,0,0,0,0,0,59,155,214,2,28,30
8,6,14,0,0,0,0,0,0,8,6,14,0,0,0
1,0,1,0,0,0,0,0,0,1,0,1,0,0,0
2,0,2,0,0,0,0,0,0,2,0,2,0,0,0
1,0,1,0,0,0,0,0,0,1,0,1,0,0,0
32,108,140,0,0,0,0,0,0,32,107,139,0,1,1
241,884,1125,0,0,0,0,0,0,219,754,973,22,130,152
1,0,1,0,0,0,0,0,0,1,0,1,0,0,0
0,1,1,0,0,0,0,0,0,0,1,1,0,0,0
1,0,1,0,0,0,0,0,0,1,0,1,0,0,0
1,1,2,0,0,0,0,0,0,1,1,2,0,0,0
10,14,24,0,0,0,0,0,0,10,14,24,0,0,0
16,1,17,0,0,0,0,0,0,9,1,10,7,0,7
1,0,1,0,0,0,0,0,0,1,0,1,0,0,0
2,0,2,0,0,0,0,0,0,2,0,2,0,0,0
1,0,1,0,0,0,0,0,0,1,0,1,0,0,0
1,0,1,0,0,0,0,0,0,1,0,1,0,0,0
1,0,1,0,0,0,0,0,0,1,0,1,0,0,0
3,0,3,0,0,0,0,0,0,3,0,3,0,0,0
2,0,2,0,0,0,0,0,0,2,0,2,0,0,0
1,0,1,0,0,0,0,0,0,1,0,1,0,0,0
7,1,8,0,0,0,0,0,0,6,1,7,1,0,1
1,0,1,0,0,0,0,0,0,1,0,1,0,0,0
6,1,7,0,0,0,0,0,0,6,1,7,0,0,0
2,0,2,0,0,0,0,0,0,2,0,2,0,0,0
1,0,1,0,0,0,0,0,0,1,0,1,0,0,0
2,0,2,0,0,0,0,0,0,2,0,2,0,0,0
1,0,1,0,0,0,0,0,0,1,0,1,0,0,0
1,0,1,0,0,0,0,0,0,1,0,1,0,0,0
0,1,1,0,0,0,0,0,0,0,1,1,0,0,0
0,3,3,0,0,0,0,0,0,0,3,3,0,0,0
0,1,1,0,0,0,0,0,0,0,1,1,0,0,0
0,4,4,0,0,0,0,0,0,0,4,4,0,0,0
0,2,2,0,0,0,0,0,0,0,2,2,0,0,0
0,1,1,0,0,0,0,0,0,0,1,1,0,0,0
0,2,2,0,0,0,0,0,0,0,2,2,0,0,0
1,8,9,0,0,0,0,0,0,1,8,9,0,0,0
0,1,1,0,0,0,0,0,0,0,1,1,0,0,0
0,2,2,0,0,0,0,0,0,0,2,2,0,0,0
0,4,4,0,0,0,0,0,0,0,4,4,0,0,0
0,9,9,0,0,0,0,0,0,0,9,9,0,0,0
0,4,4,0,0,0,0,0,0,0,4,4,0,0,0
0,6,6,0,0,0,0,0,0,0,6,6,0,0,0
0,11,11,0,0,0,0,0,0,0,11,11,0,0,0
0,8,8,0,0,0,0,0,0,0,8,8,0,0,0
0,18,18,0,0,0,0,0,0,0,18,18,0,0,0
0,1,1,0,0,0,0,0,0,0,1,1,0,0,0
0,1,1,0,0,0,0,0,0,0,1,1,0,0,0
0,6,6,0,0,0,0,0,0,0,6,6,0,0,0
1,36,37,0,0,0,0,0,0,1,35,36,0,1,1
0,4,4,0,0,0,0,0,0,0,4,4,0,0,0
0,1,1,0,0,0,0,0,0,0,1,1,0,0,0
0,2,2,0,0,0,0,0,0,0,2,2,0,0,0
0,2,2,0,0,0,0,0,0,0,2,2,0,0,0
0,11,11,0,0,0,0,0,0,0,11,11,0,0,0
0,12,12,0,0,0,0,0,0,0,12,12,0,0,0
0,1,1,0,0,0,0,0,0,0,1,1,0,0,0
0,1,1,0,0,0,0,0,0,0,1,1,0,0,0
0,1,1,0,0,0,0,0,0,0,1,1,0,0,0
0,1,1,0,0,0,0,0,0,0,1,1,0,0,0
0,99,99,0,0,0,0,0,0,0,94,94,0,5,5
0,1,1,0,0,0,0,0,0,0,1,1,0,0,0
0,1,1,0,0,0,0,0,0,0,1,1,0,0,0
0,26,26,0,0,0,0,0,0,0,24,24,0,2,2
0,1,1,0,0,0,0,0,0,0,1,1,0,0,0
0,1,1,0,0,0,0,0,0,0,1,1,0,0,0
0,5,5,0,0,0,0,0,0,0,3,3,0,2,2
0,1,1,0,0,0,0,0,0,0,1,1,0,0,0
0,2,2,0,0,0,0,0,0,0,2,2,0,0,0
1,69,70,0,0,0,0,0,0,1,54,55,0,15,15
0,7,7,0,0,0,0,0,0,0,6,6,0,1,1
0,2,2,0,0,0,0,0,0,0,2,2,0,0,0
0,3,3,0,0,0,0,0,0,0,3,3,0,0,0
0,1,1,0,0,0,0,0,0,0,1,1,0,0,0
0,5,5,0,0,0,0,0,0,0,4,4,0,1,1
0,1,1,0,0,0,0,0,0,0,1,1,0,0,0
0,3,3,0,0,0,0,0,0,0,3,3,0,0,0
0,1,1,0,0,0,0,0,0,0,1,1,0,0,0
0,8,8,0,0,0,0,0,0,0,8,8,0,0,0
0,98,98,0,0,0,0,0,0,0,81,81,0,17,17
0,2,2,0,0,0,0,0,0,0,2,2,0,0,0
0,3,3,0,0,0,0,0,0,0,3,3,0,0,0
1,12,13,0,0,0,0,0,0,1,11,12,0,1,1
1,12,13,0,0,0,0,0,0,1,12,13,0,0,0
0,45,45,0,0,0,0,0,0,0,41,41,0,4,4
0,10,10,0,0,0,0,0,0,0,10,10,0,0,0
0,2,2,0,0,0,0,0,0,0,1,1,0,1,1
0,2,2,0,0,0,0,0,0,0,2,2,0,0,0
0,1,1,0,0,0,0,0,0,0,1,1,0,0,0
0,3,3,0,0,0,0,0,0,0,3,3,0,0,0
0,1,1,0,0,0,0,0,0,0,1,1,0,0,0
0,8,8,0,0,0,0,0,0,0,8,8,0,0,0
0,3,3,0,0,0,0,0,0,0,3,3,0,0,0
0,39,39,0,0,0,0,0,0,0,30,30,0,9,9
0,5,5,0,0,0,0,0,0,0,4,4,0,1,1
0,7,7,0,0,0,0,0,0,0,6,6,0,1,1
0,1,1,0,0,0,0,0,0,0,1,1,0,0,0
0,126,126,0,0,0,0,0,0,0,100,100,0,26,26
0,1,1,0,0,0,0,0,0,0,1,1,0,0,0
0,1,1,0,0,0,0,0,0,0,1,1,0,0,0
0,2,2,0,0,0,0,0,0,0,2,2,0,0,0
0,2,2,0,0,0,0,0,0,0,2,2,0,0,0
0,2,2,0,0,0,0,0,0,0,2,2,0,0,0
0,13,13,0,0,0,0,0,0,0,12,12,0,1,1
0,5,5,0,0,0,0,0,0,0,4,4,0,1,1
0,1,1,0,0,0,0,0,0,0,1,1,0,0,0
0,1,1,0,0,0,0,0,0,0,1,1,0,0,0
0,3,3,0,0,0,0,0,0,0,3,3,0,0,0
0,1,1,0,0,0,0,0,0,0,1,1,0,0,0
0,1,1,0,0,0,0,0,0,0,1,1,0,0,0
0,1,1,0,0,0,0,0,0,0,1,1,0,0,0
0,2,2,0,0,0,0,0,0,0,2,2,0,0,0
0,2,2,0,0,0,0,0,0,0,2,2,0,0,0
0,3,3,0,0,0,0,0,0,0,3,3,0,0,0
0,2,2,0,0,0,0,0,0,0,2,2,0,0,0
0,4,4,0,0,0,0,0,0,0,4,4,0,0,0
0,6,6,0,0,0,0,0,0,0,4,4,0,2,2
0,1,1,0,0,0,0,0,0,0,1,1,0,0,0
0,1,1,0,0,0,0,0,0,0,1,1,0,0,0
0,2,2,0,0,0,0,0,0,0,2,2,0,0,0
0,7,7,0,0,0,0,0,0,0,7,7,0,0,0
0,5,5,0,0,0,0,0,0,0,3,3,0,2,2
0,5,5,0,0,0,0,0,0,0,2,2,0,3,3
0,1,1,0,0,0,0,0,0,0,1,1,0,0,0
0,1,1,0,0,0,0,0,0,0,1,1,0,0,0
0,1,1,0,0,0,0,0,0,0,1,1,0,0,0
0,16,16,0,0,0,0,0,0,0,7,7,0,9,9
0,6,6,0,0,0,0,0,0,0,5,5,0,1,1
0,8,8,0,0,0,0,0,0,0,7,7,0,1,1
0,42,42,0,0,0,0,0,0,0,37,37,0,5,5
0,5,5,0,0,0,0,0,0,0,5,5,0,0,0
0,27,27,0,0,0,0,0,0,0,22,22,0,5,5
0,26,26,0,0,0,0,0,0,0,24,24,0,2,2
0,9,9,0,0,0,0,0,0,0,9,9,0,0,0
0,1,1,0,0,0,0,0,0,0,1,1,0,0,0
0,2,2,0,0,0,0,0,0,0,2,2,0,0,0
0,3,3,0,0,0,0,0,0,0,3,3,0,0,0
0,8,8,0,0,0,0,0,0,0,7,7,0,1,1
0,4,4,0,0,0,0,0,0,0,4,4,0,0,0
0,15,15,0,0,0,0,0,0,0,15,15,0,0,0
0,2,2,0,0,0,0,0,0,0,2,2,0,0,0
0,30,30,0,0,0,0,0,0,0,26,26,0,4,4
0,1,1,0,0,0,0,0,0,0,1,1,0,0,0
0,4,4,0,0,0,0,0,0,0,4,4,0,0,0
0,1,1,0,0,0,0,0,0,0,1,1,0,0,0
3,12,15,0,0,0,0,0,0,3,11,14,0,1,1
0,9,9,0,0,0,0,0,0,0,7,7,0,2,2
0,5,5,0,0,0,0,0,0,0,3,3,0,2,2
0,4,4,0,0,0,0,0,0,0,3,3,0,1,1
0,1,1,0,0,0,0,0,0,0,1,1,0,0,0
0,1,1,0,0,0,0,0,0,0,1,1,0,0,0
1,18,19,0,0,0,0,0,0,1,18,19,0,0,0
0,7,7,0,0,0,0,0,0,0,5,5,0,2,2
0,6,6,0,0,0,0,0,0,0,3,3,0,3,3
0,2,2,0,0,0,0,0,0,0,1,1,0,1,1
0,1,1,0,0,0,0,0,0,0,1,1,0,0,0
0,4,4,0,0,0,0,0,0,0,3,3,0,1,1
0,1,1,0,0,0,0,0,0,0,1,1,0,0,0
0,1,1,0,0,0,0,0,0,0,1,1,0,0,0
0,41,41,0,0,0,0,0,0,0,29,29,0,12,12
0,4,4,0,0,0,0,0,0,0,1,1,0,3,3
0,1,1,0,0,0,0,0,0,0,1,1,0,0,0
0,1,1,0,0,0,0,0,0,0,1,1,0,0,0
0,1,1,0,0,0,0,0,0,0,1,1,0,0,0
0,1,1,0,0,0,0,0,0,0,1,1,0,0,0
0,1,1,0,0,0,0,0,0,0,1,1,0,0,0
0,1,1,0,0,0,0,0,0,0,1,1,0,0,0
0,1,1,0,0,0,0,0,0,0,1,1,0,0,0
0,4,4,0,0,0,0,0,0,0,4,4,0,0,0
0,2,2,0,0,0,0,0,0,0,2,2,0,0,0
0,2,2,0,0,0,0,0,0,0,2,2,0,0,0
0,2,2,0,0,0,0,0,0,0,2,2,0,0,0
0,1,1,0,0,0,0,0,0,0,1,1,0,0,0
0,1,1,0,0,0,0,0,0,0,1,1,0,0,0
0,4,4,0,0,0,0,0,0,0,3,3,0,1,1
0,5,5,0,0,0,0,0,0,0,5,5,0,0,0
0,1,1,0,0,0,0,0,0,0,1,1,0,0,0
0,6,6,0,0,0,0,0,0,0,5,5,0,1,1
0,5,5,0,1,1,0,0,0,0,5,5,0,0,0
0,14,14,0,0,0,0,0,0,0,12,12,0,2,2
0,1,1,0,0,0,0,0,0,0,1,1,0,0,0
0,1,1,0,0,0,0,0,0,0,1,1,0,0,0
0,1,1,0,0,0,0,0,0,0,1,1,0,0,0
0,1,1,0,0,0,0,0,0,0,1,1,0,0,0
0,1,1,0,0,0,0,0,0,0,1,1,0,0,0
0,1,1,0,0,0,0,0,0,0,1,1,0,0,0
0,2,2,0,0,0,0,0,0,0,2,2,0,0,0
0,2,2,0,0,0,0,0,0,0,2,2,0,0,0
0,2,2,0,0,0,0,0,0,0,2,2,0,0,0
0,4,4,0,0,0,0,0,0,0,4,4,0,0,0
0,1,1,0,0,0,0,0,0,0,1,1,0,0,0
0,1,1,0,0,0,0,0,0,0,1,1,0,0,0
0,1,1,0,0,0,0,0,0,0,1,1,0,0,0
0,1,1,0,0,0,0,0,0,0,1,1,0,0,0
0,1,1,0,0,0,0,0,0,0,1,1,0,0,0
0,5,5,0,0,0,0,0,0,0,5,5,0,0,0
0,1,1,0,0,0,0,0,0,0,1,1,0,0,0
0,3,3,0,0,0,0,0,0,0,3,3,0,0,0
0,1,1,0,0,0,0,0,0,0,1,1,0,0,0
0,1,1,0,0,0,0,0,0,0,1,1,0,0,0
0,2,2,0,0,0,0,0,0,0,2,2,0,0,0
0,2,2,0,0,0,0,0,0,0,2,2,0,0,0
0,2,2,0,0,0,0,0,0,0,2,2,0,0,0
0,1,1,0,0,0,0,0,0,0,1,1,0,0,0
0,1,1,0,0,0,0,0,0,0,1,1,0,0,0
0,1,1,0,0,0,0,0,0,0,1,1,0,0,0
0,2,2,0,0,0,0,0,0,0,1,1,0,1,1
1,10,11,0,0,0,0,0,0,1,9,10,0,1,1
0,1,1,0,0,0,0,0,0,0,1,1,0,0,0
0,58,58,0,0,0,0,0,0,0,44,44,0,14,14
0,2,2,0,0,0,0,0,0,0,2,2,0,0,0
0,1,1,0,0,0,0,0,0,0,1,1,0,0,0
0,2,2,0,0,0,0,0,0,0,2,2,0,0,0
0,1,1,0,0,0,0,0,0,0,1,1,0,0,0
1,0,1,0,0,0,0,0,0,1,0,1,0,0,0
0,1,1,0,0,0,0,0,0,0,1,1,0,0,0
1,0,1,0,0,0,0,0,0,1,0,1,0,0,0
0,1,1,0,0,0,0,0,0,0,1,1,0,0,0
3,0,3,0,0,0,0,0,0,3,0,3,0,0,0
0,1,1,0,0,0,0,0,0,0,1,1,0,0,0
1,1,2,0,0,0,0,0,0,1,1,2,0,0,0
0,2,2,0,0,0,0,0,0,0,2,2,0,0,0
0,1,1,0,0,0,0,0,0,0,1,1,0,0,0
0,1,1,0,0,0,0,0,0,0,1,1,0,0,0
1,0,1,0,0,0,0,0,0,1,0,1,0,0,0
0,1,1,0,0,0,0,0,0,0,1,1,0,0,0
0,1,1,0,0,0,0,0,0,0,1,1,0,0,0
0,1,1,0,0,0,0,0,0,0,1,1,0,0,0
0,1,1,0,0,0,0,0,0,0,1,1,0,0,0
0,1,1,0,0,0,0,0,0,0,1,1,0,0,0
1,0,1,0,0,0,0,0,0,1,0,1,0,0,0
0,1,1,0,0,0,0,0,0,0,1,1,0,0,0
1,0,1,0,0,0,0,0,0,1,0,1,0,0,0
0,1,1,0,0,0,0,0,0,0,1,1,0,0,0
0,1,1,0,0,0,0,0,0,0,0,0,0,1,1
0,1,1,0,0,0,0,0,0,0,1,1,0,0,0
0,3,3,0,0,0,0,0,0,0,2,2,0,1,1
0,1,1,0,0,0,0,0,0,0,1,1,0,0,0
1,0,1,0,0,0,0,0,0,1,0,1,0,0,0
0,1,1,0,0,0,0,0,0,0,1,1,0,0,0
0,1,1,0,0,0,0,0,0,0,1,1,0,0,0
0,1,1,0,0,0,0,0,0,0,1,1,0,0,0
0,1,1,0,0,0,0,0,0,0,1,1,0,0,0
1,1,2,0,0,0,0,0,0,1,1,2,0,0,0
1,1,2,0,0,0,0,0,0,1,1,2,0,0,0
0,1,1,0,0,0,0,0,0,0,1,1,0,0,0
7,9,16,0,0,0,0,0,0,7,9,16,0,0,0
9,17,26,0,0,0,0,0,0,9,17,26,0,0,0
1,0,1,0,0,0,0,0,0,1,0,1,0,0,0
1,0,1,0,0,0,0,0,0,1,0,1,0,0,0
0,1,1,0,0,0,0,0,0,0,1,1,0,0,0
1,1,2,0,0,0,0,0,0,1,1,2,0,0,0
2,1,3,0,0,0,0,0,0,2,1,3,0,0,0
5,0,5,0,0,0,0,0,0,5,0,5,0,0,0
6,4,10,0,0,0,0,0,0,6,4,10,0,0,0
2,6,8,0,0,0,0,0,0,2,6,8,0,0,0
2,9,11,0,0,0,0,0,0,2,9,11,0,0,0
1,2,3,0,0,0,0,0,0,1,2,3,0,0,0
0,2,2,0,0,0,0,0,0,0,2,2,0,0,0
12,41,53,0,0,0,0,0,0,12,41,53,0,0,0
7,42,49,0,0,0,0,0,0,7,41,48,0,1,1
31,41,72,0,0,0,0,0,0,31,41,72,0,0,0
1,0,1,0,0,0,0,0,0,1,0,1,0,0,0
1,0,1,0,0,0,0,0,0,1,0,1,0,0,0
0,1,1,0,0,0,0,0,0,0,1,1,0,0,0
0,1,1,0,0,0,0,0,0,0,1,1,0,0,0
9,16,25,0,0,0,0,0,0,9,16,25,0,0,0
0,1,1,0,0,0,0,0,0,0,1,1,0,0,0
0,2,2,0,0,0,0,0,0,0,2,2,0,0,0
1,0,1,0,0,0,0,0,0,1,0,1,0,0,0
2,1,3,0,0,0,0,0,0,2,1,3,0,0,0
1,0,1,0,0,0,0,0,0,1,0,1,0,0,0
67,77,144,0,0,0,0,0,0,65,74,139,2,3,5
2,0,2,0,0,0,0,0,0,2,0,2,0,0,0
3,1,4,0,0,0,0,0,0,3,1,4,0,0,0
0,1,1,0,0,0,0,0,0,0,1,1,0,0,0
0,1,1,0,0,0,0,0,0,0,1,1,0,0,0
1,0,1,0,0,0,0,0,0,1,0,1,0,0,0
3,2,5,0,0,0,0,0,0,3,2,5,0,0,0
1,1,2,0,0,0,0,0,0,1,1,2,0,0,0
4,0,4,0,0,0,0,0,0,4,0,4,0,0,0
10,18,28,0,0,0,0,0,0,10,18,28,0,0,0
1,0,1,0,0,0,0,0,0,1,0,1,0,0,0
1,4,5,0,0,0,0,0,0,1,4,5,0,0,0
1,2,3,0,0,0,0,0,0,1,2,3,0,0,0
0,1,1,0,0,0,0,0,0,0,1,1,0,0,0
0,1,1,0,0,0,0,0,0,0,1,1,0,0,0
7,5,12,0,0,0,0,0,0,7,5,12,0,0,0
30,66,96,0,0,0,0,0,0,30,63,93,0,3,3
1,1,2,0,0,0,0,0,0,1,1,2,0,0,0
3,3,6,0,0,0,0,0,0,3,3,6,0,0,0
1,1,2,0,0,0,0,0,0,1,1,2,0,0,0
4,5,9,0,0,0,0,0,0,4,5,9,0,0,0
12,18,30,0,0,0,0,0,0,12,18,30,0,0,0
0,1,1,0,0,0,0,0,0,0,1,1,0,0,0
0,1,1,0,0,0,0,0,0,0,1,1,0,0,0
1,1,2,0,0,0,0,0,0,1,1,2,0,0,0
4,1,5,0,0,0,0,0,0,4,1,5,0,0,0
1,0,1,0,0,0,0,0,0,1,0,1,0,0,0
2,0,2,0,0,0,0,0,0,1,0,1,1,0,1
0,1,1,0,0,0,0,0,0,0,1,1,0,0,0
1,3,4,0,0,0,0,0,0,1,2,3,0,1,1
1,0,1,0,0,0,0,0,0,1,0,1,0,0,0
1,0,1,0,0,0,0,0,0,1,0,1,0,0,0
1,0,1,0,0,0,0,0,0,1,0,1,0,0,0
54,90,144,0,0,0,0,0,0,53,90,143,1,0,1
9,11,20,0,0,0,0,0,0,9,11,20,0,0,0
2,0,2,0,0,0,0,0,0,2,0,2,0,0,0
1,2,3,0,0,0,0,0,0,1,2,3,0,0,0
0,1,1,0,0,0,0,0,0,0,1,1,0,0,0
0,2,2,0,0,0,0,0,0,0,2,2,0,0,0
0,3,3,0,0,0,0,0,0,0,3,3,0,0,0
0,1,1,0,0,0,0,0,0,0,1,1,0,0,0
1,0,1,0,0,0,0,0,0,1,0,1,0,0,0
1,1,2,0,0,0,0,0,0,1,1,2,0,0,0
0,2,2,0,0,0,0,0,0,0,1,1,0,1,1
0,1,1,0,0,0,0,0,0,0,1,1,0,0,0
8,6,14,0,0,0,0,0,0,8,6,14,0,0,0
1,0,1,0,0,0,0,0,0,1,0,1,0,0,0
1,1,2,0,0,0,0,0,0,1,1,2,0,0,0
0,1,1,0,0,0,0,0,0,0,1,1,0,0,0
1,2,3,0,0,0,0,0,0,1,2,3,0,0,0
1,1,2,0,0,0,0,0,0,1,1,2,0,0,0
3,1,4,0,0,0,0,0,0,3,1,4,0,0,0
5,2,7,0,0,0,0,0,0,5,2,7,0,0,0
0,1,1,0,0,0,0,0,0,0,1,1,0,0,0
0,1,1,0,0,0,0,0,0,0,1,1,0,0,0
0,2,2,0,0,0,0,0,0,0,2,2,0,0,0
1,0,1,0,0,0,0,0,0,1,0,1,0,0,0
0,1,1,0,0,0,0,0,0,0,1,1,0,0,0
2,0,2,0,0,0,0,0,0,2,0,2,0,0,0
1,0,1,0,0,0,0,0,0,1,0,1,0,0,0
1,0,1,0,0,0,0,0,0,1,0,1,0,0,0
0,2,2,0,0,0,0,0,0,0,2,2,0,0,0
1,0,1,0,0,0,0,0,0,1,0,1,0,0,0
0,3,3,0,0,0,0,0,0,0,3,3,0,0,0
9,9,18,0,0,0,0,0,0,8,9,17,1,0,1
0,2,2,0,0,0,0,0,0,0,2,2,0,0,0
1,0,1,0,0,0,0,0,0,1,0,1,0,0,0
3,0,3,0,0,0,0,0,0,3,0,3,0,0,0
3,2,5,0,0,0,0,0,0,3,2,5,0,0,0
0,1,1,0,0,0,0,0,0,0,1,1,0,0,0
1,0,1,0,0,0,0,0,0,1,0,1,0,0,0
0,1,1,0,0,0,0,0,0,0,1,1,0,0,0
1,4,5,0,0,0,0,0,0,1,3,4,0,1,1
0,1,1,0,0,0,0,0,0,0,1,1,0,0,0
1,0,1,1,0,1,0,0,0,1,0,1,0,0,0
0,1,1,0,0,0,0,0,0,0,1,1,0,0,0
1,0,1,0,0,0,0,0,0,1,0,1,0,0,0
6,4,10,0,0,0,0,0,0,6,4,10,0,0,0
1,0,1,0,0,0,0,0,0,1,0,1,0,0,0
0,1,1,0,0,0,0,0,0,0,1,1,0,0,0
0,1,1,0,0,0,0,0,0,0,1,1,0,0,0
1,0,1,0,0,0,0,0,0,1,0,1,0,0,0
1,0,1,0,0,0,0,0,0,1,0,1,0,0,0
3,3,6,0,0,0,0,0,0,3,3,6,0,0,0
0,1,1,0,0,0,0,0,0,0,1,1,0,0,0
1,0,1,0,0,0,0,0,0,1,0,1,0,0,0
10,5,15,0,0,0,0,0,0,10,5,15,0,0,0
1,1,2,0,0,0,0,0,0,1,1,2,0,0,0
2,1,3,0,0,0,0,0,0,2,1,3,0,0,0
0,1,1,0,0,0,0,0,0,0,1,1,0,0,0
1,1,2,0,0,0,0,0,0,1,1,2,0,0,0
1,1,2,0,0,0,0,0,0,1,1,2,0,0,0
0,1,1,0,0,0,0,0,0,0,1,1,0,0,0
1,1,2,0,0,0,0,0,0,1,1,2,0,0,0
1,1,2,0,0,0,0,0,0,1,1,2,0,0,0
1,0,1,0,0,0,0,0,0,1,0,1,0,0,0
1,0,1,0,0,0,0,0,0,1,0,1,0,0,0
3,0,3,0,0,0,0,0,0,3,0,3,0,0,0
1,0,1,0,0,0,0,0,0,1,0,1,0,0,0
2,2,4,0,0,0,0,0,0,1,2,3,1,0,1
1,0,1,0,0,0,0,0,0,1,0,1,0,0,0
1,0,1,0,0,0,0,0,0,1,0,1,0,0,0
3,1,4,0,0,0,0,0,0,3,1,4,0,0,0
1,0,1,0,0,0,0,0,0,1,0,1,0,0,0
12,9,21,0,0,0,0,0,0,11,9,20,1,0,1
1,0,1,0,0,0,0,0,0,1,0,1,0,0,0
0,1,1,0,0,0,0,0,0,0,1,1,0,0,0
0,1,1,0,0,0,0,0,0,0,1,1,0,0,0
0,4,4,0,0,0,0,0,0,0,4,4,0,0,0
0,2,2,0,0,0,0,0,0,0,2,2,0,0,0
1,1,2,0,0,0,0,0,0,1,1,2,0,0,0
0,1,1,0,0,0,0,0,0,0,1,1,0,0,0
2,1,3,0,0,0,0,0,0,2,1,3,0,0,0
1,0,1,0,0,0,0,0,0,1,0,1,0,0,0
1,0,1,0,0,0,0,0,0,1,0,1,0,0,0
1,1,2,0,0,0,0,0,0,1,1,2,0,0,0
3,2,5,0,0,0,0,0,0,3,2,5,0,0,0
0,1,1,0,0,0,0,0,0,0,1,1,0,0,0
1,0,1,0,0,0,0,0,0,1,0,1,0,0,0
2,0,2,0,0,0,0,0,0,2,0,2,0,0,0
8,9,17,0,0,0,0,0,0,8,9,17,0,0,0
1,0,1,0,0,0,0,0,0,1,0,1,0,0,0
3,1,4,0,0,0,0,0,0,3,1,4,0,0,0
1,0,1,0,0,0,0,0,0,1,0,1,0,0,0
0,1,1,0,0,0,0,0,0,0,1,1,0,0,0
0,1,1,0,0,0,0,0,0,0,1,1,0,0,0
1,1,2,0,0,0,0,0,0,1,1,2,0,0,0
1,0,1,0,0,0,0,0,0,1,0,1,0,0,0
0,1,1,0,0,0,0,0,0,0,1,1,0,0,0
1,0,1,0,0,0,0,0,0,1,0,1,0,0,0
1,5,6,0,0,0,0,0,0,1,5,6,0,0,0
5,6,11,0,0,0,0,0,0,5,6,11,0,0,0
0,1,1,0,0,0,0,0,0,0,1,1,0,0,0
1,0,1,0,0,0,0,0,0,1,0,1,0,0,0
0,1,1,0,0,0,0,0,0,0,1,1,0,0,0
1,0,1,0,0,0,0,0,0,1,0,1,0,0,0
0,1,1,0,0,0,0,0,0,0,1,1,0,0,0
4,3,7,0,0,0,0,0,0,2,3,5,2,0,2
1,0,1,0,0,0,0,0,0,1,0,1,0,0,0
3,0,3,0,0,0,0,0,0,3,0,3,0,0,0
1,0,1,0,0,0,0,0,0,1,0,1,0,0,0
1,0,1,0,0,0,0,0,0,1,0,1,0,0,0
0,3,3,0,0,0,0,0,0,0,3,3,0,0,0
2,1,3,0,0,0,0,0,0,0,1,1,2,0,2
1,0,1,0,0,0,0,0,0,1,0,1,0,0,0
4,7,11,0,0,0,0,0,0,4,7,11,0,0,0
1,1,2,0,0,0,0,0,0,1,1,2,0,0,0
1,1,2,0,0,0,0,0,0,1,1,2,0,0,0
0,2,2,0,0,0,0,0,0,0,2,2,0,0,0
4,5,9,0,0,0,0,0,0,4,5,9,0,0,0
0,1,1,0,0,0,0,0,0,0,1,1,0,0,0
0,1,1,0,0,0,0,0,0,0,1,1,0,0,0
1,0,1,0,0,0,0,0,0,1,0,1,0,0,0
1,1,2,0,0,0,0,0,0,1,1,2,0,0,0
0,1,1,0,0,0,0,0,0,0,1,1,0,0,0
2,1,3,0,0,0,0,0,0,2,1,3,0,0,0
1,0,1,0,0,0,0,0,0,1,0,1,0,0,0
0,1,1,0,0,0,0,0,0,0,1,1,0,0,0
1,0,1,0,0,0,0,0,0,1,0,1,0,0,0
3,0,3,0,0,0,0,0,0,3,0,3,0,0,0
0,1,1,0,0,0,0,0,0,0,1,1,0,0,0
3,0,3,0,0,0,0,0,0,2,0,2,1,0,1
1,2,3,0,0,0,0,0,0,1,1,2,0,1,1
0,1,1,0,0,0,0,0,0,0,1,1,0,0,0
2,2,4,0,0,0,0,0,0,2,2,4,0,0,0
1,1,2,0,0,0,0,0,0,1,1,2,0,0,0
1,0,1,0,0,0,0,0,0,1,0,1,0,0,0
5,11,16,0,0,0,0,0,0,5,11,16,0,0,0
2,2,4,0,0,0,0,0,0,2,2,4,0,0,0
3,4,7,0,0,0,0,0,0,3,4,7,0,0,0
1,0,1,0,0,0,0,0,0,1,0,1,0,0,0
1,0,1,0,0,0,0,0,0,1,0,1,0,0,0
1,0,1,0,0,0,0,0,0,1,0,1,0,0,0
0,1,1,0,0,0,0,0,0,0,1,1,0,0,0
0,1,1,0,0,0,0,0,0,0,1,1,0,0,0
1,0,1,0,0,0,0,0,0,1,0,1,0,0,0
0,1,1,0,0,0,0,0,0,0,1,1,0,0,0
3,0,3,0,0,0,0,0,0,3,0,3,0,0,0
0,1,1,0,0,0,0,0,0,0,1,1,0,0,0
1,2,3,0,0,0,0,0,0,1,2,3,0,0,0
1,0,1,0,0,0,0,0,0,1,0,1,0,0,0
0,1,1,0,0,0,0,0,0,0,1,1,0,0,0
0,1,1,0,0,0,0,0,0,0,1,1,0,0,0
0,1,1,0,0,0,0,0,0,0,1,1,0,0,0
2,5,7,0,0,0,0,0,0,2,5,7,0,0,0
1,0,1,0,0,0,0,0,0,1,0,1,0,0,0
1,0,1,0,0,0,0,0,0,1,0,1,0,0,0
2,4,6,0,0,0,0,0,0,2,3,5,0,1,1
2,1,3,0,0,0,0,0,0,2,1,3,0,0,0
0,1,1,0,0,0,0,0,0,0,1,1,0,0,0
1,0,1,0,0,0,0,0,0,1,0,1,0,0,0
0,1,1,0,0,0,0,0,0,0,1,1,0,0,0
0,3,3,0,0,0,0,0,0,0,3,3,0,0,0
1,0,1,0,0,0,0,0,0,1,0,1,0,0,0
1,0,1,0,0,0,0,0,0,1,0,1,0,0,0
0,1,1,0,0,0,0,0,0,0,1,1,0,0,0
3,1,4,0,0,0,0,0,0,3,1,4,0,0,0
1,1,2,0,0,0,0,0,0,1,1,2,0,0,0
0,1,1,0,0,0,0,0,0,0,1,1,0,0,0
0,1,1,0,0,0,0,0,0,0,1,1,0,0,0
0,2,2,0,0,0,0,0,0,0,2,2,0,0,0
0,3,3,0,0,0,0,0,0,0,2,2,0,1,1
1,1,2,0,0,0,0,0,0,1,1,2,0,0,0
2,1,3,0,0,0,0,0,0,2,1,3,0,0,0
0,1,1,0,0,0,0,0,0,0,1,1,0,0,0
1,0,1,0,0,0,0,0,0,1,0,1,0,0,0
1,0,1,0,0,0,0,0,0,1,0,1,0,0,0
1,1,2,0,0,0,0,0,0,1,1,2,0,0,0
0,3,3,0,0,0,0,0,0,0,2,2,0,1,1
0,1,1,0,0,0,0,0,0,0,1,1,0,0,0
1,1,2,0,0,0,0,0,0,1,1,2,0,0,0
1,0,1,0,0,0,0,0,0,1,0,1,0,0,0
1,0,1,0,0,0,0,0,0,1,0,1,0,0,0
0,1,1,0,0,0,0,0,0,0,1,1,0,0,0
1,2,3,0,0,0,0,0,0,1,2,3,0,0,0
0,1,1,0,0,0,0,0,0,0,1,1,0,0,0
0,1,1,0,0,0,0,0,0,0,1,1,0,0,0
0,1,1,0,0,0,0,0,0,0,1,1,0,0,0
0,1,1,0,0,0,0,0,0,0,1,1,0,0,0
1,0,1,0,0,0,0,0,0,1,0,1,0,0,0
0,1,1,0,0,0,0,0,0,0,1,1,0,0,0
1,0,1,0,0,0,0,0,0,1,0,1,0,0,0
0,1,1,0,0,0,0,0,0,0,1,1,0,0,0
2,9,11,0,1,1,0,0,0,2,9,11,0,0,0
1,0,1,0,0,0,0,0,0,1,0,1,0,0,0
1,0,1,0,0,0,0,0,0,1,0,1,0,0,0
0,1,1,0,0,0,0,0,0,0,1,1,0,0,0
1,0,1,0,0,0,0,0,0,1,0,1,0,0,0
1,1,2,0,0,0,0,0,0,1,1,2,0,0,0
1,0,1,0,0,0,0,0,0,1,0,1,0,0,0
1,0,1,0,0,0,0,0,0,1,0,1,0,0,0
0,3,3,0,0,0,0,0,0,0,3,3,0,0,0
1,3,4,0,0,0,0,0,0,1,3,4,0,0,0
1,1,2,0,0,0,0,0,0,1,1,2,0,0,0
0,1,1,0,0,0,0,0,0,0,1,1,0,0,0
0,1,1,0,0,0,0,0,0,0,1,1,0,0,0
1,0,1,0,0,0,0,0,0,1,0,1,0,0,0
1,0,1,0,0,0,0,0,0,1,0,1,0,0,0
1,0,1,0,0,0,0,0,0,1,0,1,0,0,0
0,1,1,0,0,0,0,0,0,0,1,1,0,0,0
0,1,1,0,0,0,0,0,0,0,1,1,0,0,0
0,1,1,0,0,0,0,0,0,0,1,1,0,0,0
0,1,1,0,0,0,0,0,0,0,1,1,0,0,0
3,0,3,0,0,0,0,0,0,3,0,3,0,0,0
6,4,10,0,0,0,0,0,0,6,4,10,0,0,0
1,1,2,0,0,0,0,0,0,1,1,2,0,0,0
0,1,1,0,0,0,0,0,0,0,1,1,0,0,0
0,1,1,0,0,0,0,0,0,0,1,1,0,0,0
0,1,1,0,0,0,0,0,0,0,1,1,0,0,0
0,1,1,0,0,0,0,0,0,0,1,1,0,0,0
0,2,2,0,0,0,0,0,0,0,2,2,0,0,0
4,1,5,0,0,0,0,0,0,4,1,5,0,0,0
0,3,3,0,0,0,0,0,0,0,3,3,0,0,0
1,0,1,0,0,0,0,0,0,1,0,1,0,0,0
9,0,9,0,0,0,0,0,0,5,0,5,4,0,4
1,0,1,0,0,0,0,0,0,1,0,1,0,0,0
2,3,5,0,0,0,0,0,0,2,3,5,0,0,0
0,1,1,0,0,0,0,0,0,0,1,1,0,0,0
0,1,1,0,0,0,0,0,0,0,1,1,0,0,0
1,0,1,0,0,0,0,0,0,1,0,1,0,0,0
0,1,1,0,0,0,0,0,0,0,1,1,0,0,0
1,0,1,0,0,0,0,0,0,1,0,1,0,0,0
1,0,1,0,0,0,0,0,0,1,0,1,0,0,0
0,1,1,0,0,0,0,0,0,0,1,1,0,0,0
1,0,1,0,0,0,0,0,0,1,0,1,0,0,0
5,2,7,0,0,0,0,0,0,3,2,5,2,0,2
0,3,3,0,0,0,0,0,0,0,3,3,0,0,0
11,5,16,0,0,0,0,0,0,4,2,6,7,3,10
3,3,6,0,0,0,0,0,0,2,3,5,1,0,1
0,1,1,0,0,0,0,0,0,0,1,1,0,0,0
1,1,2,0,0,0,0,0,0,1,1,2,0,0,0
0,17,17,0,0,0,0,0,0,0,17,17,0,0,0
0,8,8,0,0,0,0,0,0,0,8,8,0,0,0
0,70,70,0,0,0,0,0,0,0,68,68,0,2,2
0,2,2,0,0,0,0,0,0,0,2,2,0,0,0
0,22,22,0,1,1,0,0,0,0,21,21,0,1,1
0,30,30,0,0,0,0,0,0,0,24,24,0,6,6
0,13,13,0,0,0,0,0,0,0,12,12,0,1,1
2,101,103,0,0,0,0,0,0,2,88,90,0,13,13
1,46,47,0,0,0,0,0,0,1,40,41,0,6,6
0,13,13,0,0,0,0,0,0,0,11,11,0,2,2
0,4,4,0,0,0,0,0,0,0,4,4,0,0,0
0,15,15,0,0,0,0,0,0,0,12,12,0,3,3
0,2,2,0,0,0,0,0,0,0,2,2,0,0,0
0,5,5,0,0,0,0,0,0,0,4,4,0,1,1
0,2,2,0,0,0,0,0,0,0,2,2,0,0,0
0,1,1,0,0,0,0,0,0,0,1,1,0,0,0
0,1,1,0,0,0,0,0,0,0,1,1,0,0,0
0,27,27,0,0,0,0,0,0,0,25,25,0,2,2
0,21,21,0,0,0,0,0,0,0,20,20,0,1,1
3,248,251,0,0,0,0,0,0,2,109,111,1,139,140
0,2,2,0,0,0,0,0,0,0,1,1,0,1,1
0,1,1,0,0,0,0,0,0,0,1,1,0,0,0
0,2,2,0,0,0,0,0,0,0,2,2,0,0,0
0,2,2,0,0,0,0,0,0,0,2,2,0,0,0
0,1,1,0,0,0,0,0,0,0,1,1,0,0,0
0,1,1,0,0,0,0,0,0,0,1,1,0,0,0
0,8,8,0,0,0,0,0,0,0,8,8,0,0,0
2,0,2,0,0,0,0,0,0,2,0,2,0,0,0
1,0,1,0,0,0,0,0,0,1,0,1,0,0,0
1,1,2,0,0,0,0,0,0,1,1,2,0,0,0
0,1,1,0,0,0,0,0,0,0,1,1,0,0,0
0,1,1,0,0,0,0,0,0,0,1,1,0,0,0
1,1,2,0,0,0,0,0,0,1,1,2,0,0,0
0,2,2,0,0,0,0,0,0,0,2,2,0,0,0
0,2,2,0,0,0,0,0,0,0,2,2,0,0,0
1,0,1,0,0,0,0,0,0,1,0,1,0,0,0
1,1,2,0,0,0,0,0,0,1,1,2,0,0,0
1,1,2,0,0,0,0,0,0,1,1,2,0,0,0
0,1,1,0,0,0,0,0,0,0,1,1,0,0,0
1,0,1,0,0,0,0,0,0,1,0,1,0,0,0
0,1,1,0,0,0,0,0,0,0,1,1,0,0,0
1,0,1,0,0,0,0,0,0,1,0,1,0,0,0
